# FROM-URL	TO-URL
/fr/docs/API_de_restauration_de_session	/fr/docs/Archive/Add-ons/API_de_restauration_de_session
/fr/docs/Applications/Quickstart/Build	/fr/docs/Archive/B2G_OS/Quickstart
/fr/docs/Applications/Quickstart/Build/Votre_premier_application	/fr/docs/Archive/B2G_OS/Quickstart/Votre_premier_application
/fr/docs/Astuces_XULRunner	/fr/docs/Archive/Mozilla/XULRunner/Astuces_XULRunner
/fr/docs/B2G_OS	/fr/docs/Archive/B2G_OS
/fr/docs/B2G_OS/API	/fr/docs/Archive/B2G_OS/API
/fr/docs/B2G_OS/API/API_Contacts	/fr/docs/Archive/B2G_OS/API/API_Contacts
/fr/docs/B2G_OS/API/UDPSocket	/fr/docs/Archive/B2G_OS/API/UDPSocket
/fr/docs/B2G_OS/API/Window	/fr/docs/Archive/B2G_OS/API/Window
/fr/docs/B2G_OS/Add-ons	/fr/docs/Archive/B2G_OS/Add-ons
/fr/docs/B2G_OS/Add-ons/Développer_des_add-ons_pour_Firefox_OS	/fr/docs/Archive/B2G_OS/Add-ons/Développer_des_add-ons_pour_Firefox_OS
/fr/docs/B2G_OS/Automated_testing	/fr/docs/Archive/B2G_OS/Automated_testing
/fr/docs/B2G_OS/Automated_testing/Configurer_Marionette	/fr/docs/Archive/B2G_OS/Automated_testing/Configurer_Marionette
/fr/docs/B2G_OS/Automated_testing/Endurance	/fr/docs/Archive/B2G_OS/Automated_testing/Endurance
/fr/docs/B2G_OS/Automated_testing/MTBF_tests	/fr/docs/Archive/B2G_OS/Automated_testing/MTBF_tests
/fr/docs/B2G_OS/Automated_testing/Marionette_pour_Python_interactif	/fr/docs/Archive/B2G_OS/Automated_testing/Marionette_pour_Python_interactif
/fr/docs/B2G_OS/Automated_testing/Reftests	/fr/docs/Archive/B2G_OS/Automated_testing/Reftests
/fr/docs/B2G_OS/Automated_testing/Test_Execution_Chart	/fr/docs/Archive/B2G_OS/Automated_testing/Test_Execution_Chart
/fr/docs/B2G_OS/Automated_testing/Tests_Cppunit	/fr/docs/Archive/B2G_OS/Automated_testing/Tests_Cppunit
/fr/docs/B2G_OS/Automated_testing/gaia-ui-tests	/fr/docs/Archive/B2G_OS/Automated_testing/gaia-ui-tests
/fr/docs/B2G_OS/Automated_testing/gaia-ui-tests/Partie_1_Marionette_Firefox_OS_commencer	/fr/docs/Archive/B2G_OS/Automated_testing/gaia-ui-tests/Partie_1_Marionette_Firefox_OS_commencer
/fr/docs/B2G_OS/Automated_testing/gaia-ui-tests/Partie_2_Marionette_Firefox_OS_interactions	/fr/docs/Archive/B2G_OS/Automated_testing/gaia-ui-tests/Partie_2_Marionette_Firefox_OS_interactions
/fr/docs/B2G_OS/Automated_testing/gaia-ui-tests/Partie_3_Tests_reutilisables	/fr/docs/Archive/B2G_OS/Automated_testing/gaia-ui-tests/Partie_3_Tests_reutilisables
/fr/docs/B2G_OS/Automated_testing/gaia-ui-tests/Partie_4_Reutiliser_commandes_Firefox_OS_configuration	/fr/docs/Archive/B2G_OS/Automated_testing/gaia-ui-tests/Partie_4_Reutiliser_commandes_Firefox_OS_configuration
/fr/docs/B2G_OS/Automated_testing/gaia-ui-tests/Partie_5_Introduction_executeur_tests	/fr/docs/Archive/B2G_OS/Automated_testing/gaia-ui-tests/Partie_5_Introduction_executeur_tests
/fr/docs/B2G_OS/Automated_testing/gaia-ui-tests/Partie_6_Marionette_classe_By	/fr/docs/Archive/B2G_OS/Automated_testing/gaia-ui-tests/Partie_6_Marionette_classe_By
/fr/docs/B2G_OS/Automated_testing/gaia-ui-tests/Partie_7_Ecrire_vos_propres_tests	/fr/docs/Archive/B2G_OS/Automated_testing/gaia-ui-tests/Partie_7_Ecrire_vos_propres_tests
/fr/docs/B2G_OS/Automated_testing/gaia-ui-tests/Partie_8_Utiliser_une_classe_base	/fr/docs/Archive/B2G_OS/Automated_testing/gaia-ui-tests/Partie_8_Utiliser_une_classe_base
/fr/docs/B2G_OS/Automated_testing/gaia-ui-tests/Partie_9_objets_app	/fr/docs/Archive/B2G_OS/Automated_testing/gaia-ui-tests/Partie_9_objets_app
/fr/docs/B2G_OS/B2G_OS_Architecture	/fr/docs/Archive/B2G_OS/B2G_OS_Architecture
/fr/docs/B2G_OS/Board_guide	/fr/docs/Archive/B2G_OS/Board_guide
/fr/docs/B2G_OS/Board_guide/CHIRIMEN	/fr/docs/Archive/B2G_OS/Board_guide/CHIRIMEN
/fr/docs/B2G_OS/Board_guide/CHIRIMEN/CHIRIMEN_FAQ	/fr/docs/Archive/B2G_OS/Board_guide/CHIRIMEN/CHIRIMEN_FAQ
/fr/docs/B2G_OS/Board_guide/CHIRIMEN/OS_Image	/fr/docs/Archive/B2G_OS/Board_guide/CHIRIMEN/OS_Image
/fr/docs/B2G_OS/Board_guide/CHIRIMEN/Quick_start_guide	/fr/docs/Archive/B2G_OS/Board_guide/CHIRIMEN/Quick_start_guide
/fr/docs/B2G_OS/Board_guide/CHIRIMEN/Quick_start_guide/basic_startup	/fr/docs/Archive/B2G_OS/Board_guide/CHIRIMEN/Quick_start_guide/basic_startup
/fr/docs/B2G_OS/Board_guide/CHIRIMEN/Quick_start_guide/board_connectors	/fr/docs/Archive/B2G_OS/Board_guide/CHIRIMEN/Quick_start_guide/board_connectors
/fr/docs/B2G_OS/Board_guide/CHIRIMEN/Quick_start_guide/dev_windows	/fr/docs/Archive/B2G_OS/Board_guide/CHIRIMEN/Quick_start_guide/dev_windows
/fr/docs/B2G_OS/Board_guide/CHIRIMEN/Quick_start_guide/firmware_update_guide_for_windows	/fr/docs/Archive/B2G_OS/Board_guide/CHIRIMEN/Quick_start_guide/firmware_update_guide_for_windows
/fr/docs/B2G_OS/Building_B2G_for_QEMU_Emulator	/fr/docs/Archive/B2G_OS/Building_B2G_for_QEMU_Emulator
/fr/docs/B2G_OS/Building_and_installing_Boot_to_Gecko	/fr/docs/Archive/B2G_OS/Building_and_installing_Boot_to_Gecko
/fr/docs/B2G_OS/Building_and_installing_Boot_to_Gecko/Appareils_compatibles	/fr/docs/Archive/B2G_OS/Building_and_installing_Boot_to_Gecko/Appareils_compatibles
/fr/docs/B2G_OS/Building_and_installing_Boot_to_Gecko/B2G_Build_Variables_Reference_Sheet	/fr/docs/Archive/B2G_OS/Building_and_installing_Boot_to_Gecko/B2G_Build_Variables_Reference_Sheet
/fr/docs/B2G_OS/Building_and_installing_Boot_to_Gecko/B2G_OS_update_packages	/fr/docs/Archive/B2G_OS/Building_and_installing_Boot_to_Gecko/B2G_OS_update_packages
/fr/docs/B2G_OS/Building_and_installing_Boot_to_Gecko/B2G_installer_add-on	/fr/docs/Archive/B2G_OS/Building_and_installing_Boot_to_Gecko/B2G_installer_add-on
/fr/docs/B2G_OS/Building_and_installing_Boot_to_Gecko/Compiler_pour_le_Flame_sur_OS_X	/fr/docs/Archive/B2G_OS/Building_and_installing_Boot_to_Gecko/Compiler_pour_le_Flame_sur_OS_X
/fr/docs/B2G_OS/Building_and_installing_Boot_to_Gecko/Configurer_votre_première_construction	/fr/docs/Archive/B2G_OS/Building_and_installing_Boot_to_Gecko/Configurer_votre_première_construction
/fr/docs/B2G_OS/Building_and_installing_Boot_to_Gecko/Construire_anciennes_branches	/fr/docs/Archive/B2G_OS/Building_and_installing_Boot_to_Gecko/Construire_anciennes_branches
/fr/docs/B2G_OS/Building_and_installing_Boot_to_Gecko/Mettre_en_place_un_environnement_de_construction	/fr/docs/Archive/B2G_OS/Building_and_installing_Boot_to_Gecko/Mettre_en_place_un_environnement_de_construction
/fr/docs/B2G_OS/Building_and_installing_Boot_to_Gecko/Résumé_processus_compilation_Firefox_OS	/fr/docs/Archive/B2G_OS/Building_and_installing_Boot_to_Gecko/Résumé_processus_compilation_Firefox_OS
/fr/docs/B2G_OS/Building_the_Firefox_OS_simulator	/fr/docs/Archive/B2G_OS/Building_the_Firefox_OS_simulator
/fr/docs/B2G_OS/Choisir_comment_lancer_Gaia_ou_B2G	/fr/docs/Archive/B2G_OS/Choisir_comment_lancer_Gaia_ou_B2G
/fr/docs/B2G_OS/Compiler	/fr/docs/Archive/B2G_OS/Compiler
/fr/docs/B2G_OS/Compiler/Building_an_engineering_build_like_the_ones_publis	/fr/docs/Archive/B2G_OS/Compiler/Building_an_engineering_build_like_the_ones_publis
/fr/docs/B2G_OS/Compiler/Compiler_pour_le_Fairphone	/fr/docs/Archive/B2G_OS/Compiler/Compiler_pour_le_Fairphone
/fr/docs/B2G_OS/Compiler/FOTA_community_builds	/fr/docs/Archive/B2G_OS/Compiler/FOTA_community_builds
/fr/docs/B2G_OS/Customisation_avec_le_fichier_.userconfig	/fr/docs/Archive/B2G_OS/Customisation_avec_le_fichier_.userconfig
/fr/docs/B2G_OS/Developer_preview_phone	/fr/docs/Archive/B2G_OS/Developer_preview_phone
/fr/docs/B2G_OS/Developing_Firefox_OS	/fr/docs/Archive/B2G_OS/Developing_Firefox_OS
/fr/docs/B2G_OS/Developing_Firefox_OS/Personnalisation_des_DNS	/fr/docs/Archive/B2G_OS/Developing_Firefox_OS/Personnalisation_des_DNS
/fr/docs/B2G_OS/Developing_Firefox_OS/Quickstart_guide_to_B2G_development	/fr/docs/Archive/B2G_OS/Developing_Firefox_OS/Quickstart_guide_to_B2G_development
/fr/docs/B2G_OS/Developing_Firefox_OS/Rapporter_Bug_Firefox_OS	/fr/docs/Archive/B2G_OS/Developing_Firefox_OS/Rapporter_Bug_Firefox_OS
/fr/docs/B2G_OS/Developing_Gaia	/fr/docs/Archive/B2G_OS/Developing_Gaia
/fr/docs/B2G_OS/Developing_Gaia/Apporter_modifications_Gaia	/fr/docs/Archive/B2G_OS/Developing_Gaia/Apporter_modifications_Gaia
/fr/docs/B2G_OS/Developing_Gaia/Bases_système_construction_Gaia	/fr/docs/Archive/B2G_OS/Developing_Gaia/Bases_système_construction_Gaia
/fr/docs/B2G_OS/Developing_Gaia/Different_ways_to_run_Gaia	/fr/docs/Archive/B2G_OS/Developing_Gaia/Different_ways_to_run_Gaia
/fr/docs/B2G_OS/Developing_Gaia/Exécuter_des_versions_personnalisées_dans_WebIDE	/fr/docs/Archive/B2G_OS/Developing_Gaia/Exécuter_des_versions_personnalisées_dans_WebIDE
/fr/docs/B2G_OS/Developing_Gaia/Faire_fonctionner_code_Gaia	/fr/docs/Archive/B2G_OS/Developing_Gaia/Faire_fonctionner_code_Gaia
/fr/docs/B2G_OS/Developing_Gaia/Gaia_tools_reference	/fr/docs/Archive/B2G_OS/Developing_Gaia/Gaia_tools_reference
/fr/docs/B2G_OS/Developing_Gaia/Guide_version_personnalisée_Gaia	/fr/docs/Archive/B2G_OS/Developing_Gaia/Guide_version_personnalisée_Gaia
/fr/docs/B2G_OS/Developing_Gaia/Localiser_Firefox_OS	/fr/docs/Archive/B2G_OS/Developing_Gaia/Localiser_Firefox_OS
/fr/docs/B2G_OS/Developing_Gaia/Personnalisation_applications_présentes_construction	/fr/docs/Archive/B2G_OS/Developing_Gaia/Personnalisation_applications_présentes_construction
/fr/docs/B2G_OS/Developing_Gaia/Personnaliser_le_clavier	/fr/docs/Archive/B2G_OS/Developing_Gaia/Personnaliser_le_clavier
/fr/docs/B2G_OS/Developing_Gaia/Référence_options_make	/fr/docs/Archive/B2G_OS/Developing_Gaia/Référence_options_make
/fr/docs/B2G_OS/Developing_Gaia/Soumettre_correctif_pour_Gaia	/fr/docs/Archive/B2G_OS/Developing_Gaia/Soumettre_correctif_pour_Gaia
/fr/docs/B2G_OS/Developing_Gaia/Tester_modifications_Gaia	/fr/docs/Archive/B2G_OS/Developing_Gaia/Tester_modifications_Gaia
/fr/docs/B2G_OS/Developing_Gaia/comprendre_les_fondements_de_Gaia	/fr/docs/Archive/B2G_OS/Developing_Gaia/comprendre_les_fondements_de_Gaia
/fr/docs/B2G_OS/Dual_boot_de_B2G_et_Android_sur_SGS2	/fr/docs/Archive/B2G_OS/Dual_boot_de_B2G_et_Android_sur_SGS2
/fr/docs/B2G_OS/Déboguer	/fr/docs/Archive/B2G_OS/Debugging
/fr/docs/B2G_OS/Déboguer/Connecting_a_Firefox_OS_device_to_the_desktop	/fr/docs/Archive/B2G_OS/Debugging/Connecting_a_Firefox_OS_device_to_the_desktop
/fr/docs/B2G_OS/Déboguer/Déboguer_avec_client_B2G	/fr/docs/Archive/B2G_OS/Debugging/Déboguer_avec_client_B2G
/fr/docs/B2G_OS/Déboguer/Installer_ADB	/fr/docs/Archive/B2G_OS/Debugging/Installer_ADB
/fr/docs/B2G_OS/Déboguer/Journalisation_console	/fr/docs/Archive/B2G_OS/Debugging/Journalisation_console
/fr/docs/B2G_OS/Déboguer/Les_paramètres_développeurs	/fr/docs/Archive/B2G_OS/Debugging/Les_paramètres_développeurs
/fr/docs/B2G_OS/Déboguer/Personnaliser_b2g.sh	/fr/docs/Archive/B2G_OS/Debugging/Personnaliser_b2g.sh
/fr/docs/B2G_OS/Déboguer/Signaler_une_erreur_Firefox_OS	/fr/docs/Archive/B2G_OS/Debugging/Signaler_une_erreur_Firefox_OS
/fr/docs/B2G_OS/Déboguer/Étapes_préparatoires	/fr/docs/Archive/B2G_OS/Debugging/Étapes_préparatoires
/fr/docs/B2G_OS/Firefox_OS_Connected-Devices_Guide	/fr/docs/Archive/B2G_OS/Firefox_OS_Connected-Devices_Guide
/fr/docs/B2G_OS/Firefox_OS_Connected-Devices_Guide/How_to_get_started_with_TV_apps_development	/fr/docs/Archive/B2G_OS/Firefox_OS_Connected-Devices_Guide/How_to_get_started_with_TV_apps_development
/fr/docs/B2G_OS/Firefox_OS_Connected-Devices_Guide/Interagir_avec_les_télécommandes_TV	/fr/docs/Archive/B2G_OS/Firefox_OS_Connected-Devices_Guide/Interagir_avec_les_télécommandes_TV
/fr/docs/B2G_OS/Firefox_OS_Connected-Devices_Guide/Simuler_Firefox_OS_pour_TV	/fr/docs/Archive/B2G_OS/Firefox_OS_Connected-Devices_Guide/Simuler_Firefox_OS_pour_TV
/fr/docs/B2G_OS/Firefox_OS_Connected-Devices_Guide/TV_remote_control_button_mapping_to_keyboard	/fr/docs/Archive/B2G_OS/Firefox_OS_Connected-Devices_Guide/TV_remote_control_button_mapping_to_keyboard
/fr/docs/B2G_OS/Firefox_OS_FAQ	/fr/docs/Archive/B2G_OS/Firefox_OS_FAQ
/fr/docs/B2G_OS/Firefox_OS_usage_tips	/fr/docs/Archive/B2G_OS/Firefox_OS_usage_tips
/fr/docs/B2G_OS/Firefox_OS_usage_tips/Unlocking_your_phone	/fr/docs/Archive/B2G_OS/Firefox_OS_usage_tips/Unlocking_your_phone
/fr/docs/B2G_OS/Gaia_hacking_guide	/fr/docs/Archive/B2G_OS/Gaia_hacking_guide
/fr/docs/B2G_OS/Guide_Telephone_Developpeur	/fr/docs/Archive/B2G_OS/Phone_guide
/fr/docs/B2G_OS/Guide_Telephone_Developpeur/Alcatel_One_Touch_Fire	/fr/docs/Archive/B2G_OS/Phone_guide/Alcatel_One_Touch_Fire
/fr/docs/B2G_OS/Guide_Telephone_Developpeur/Alcatel_One_Touch_Fire_C	/fr/docs/Archive/B2G_OS/Phone_guide/Alcatel_One_Touch_Fire_C
/fr/docs/B2G_OS/Guide_Telephone_Developpeur/Alcatel_One_Touch_Fire_E	/fr/docs/Archive/B2G_OS/Phone_guide/Alcatel_One_Touch_Fire_E
/fr/docs/B2G_OS/Guide_Telephone_Developpeur/Alcatel_One_Touch_Pixi_3_(3.5)	/fr/docs/Archive/B2G_OS/Phone_guide/Alcatel_One_Touch_Pixi_3_(3.5)
/fr/docs/B2G_OS/Guide_Telephone_Developpeur/Alcatel_Onetouch_Fire_C_4020D	/fr/docs/Archive/B2G_OS/Phone_guide/Alcatel_Onetouch_Fire_C_4020D
/fr/docs/B2G_OS/Guide_Telephone_Developpeur/Best_practices_open_reference_devices	/fr/docs/Archive/B2G_OS/Phone_guide/Best_practices_open_reference_devices
/fr/docs/B2G_OS/Guide_Telephone_Developpeur/Cherry_Mobile_Ace	/fr/docs/Archive/B2G_OS/Phone_guide/Cherry_Mobile_Ace
/fr/docs/B2G_OS/Guide_Telephone_Developpeur/Fairphone	/fr/docs/Archive/B2G_OS/Phone_guide/Fairphone
/fr/docs/B2G_OS/Guide_Telephone_Developpeur/Firefox_OS_device_features	/fr/docs/Archive/B2G_OS/Phone_guide/Firefox_OS_device_features
/fr/docs/B2G_OS/Guide_Telephone_Developpeur/Flame	/fr/docs/Archive/B2G_OS/Phone_guide/Flame
/fr/docs/B2G_OS/Guide_Telephone_Developpeur/Flame/configuration	/fr/docs/Archive/B2G_OS/Phone_guide/Flame/configuration
/fr/docs/B2G_OS/Guide_Telephone_Developpeur/Flame/mettre_a_jour_Flame	/fr/docs/Archive/B2G_OS/Phone_guide/Flame/mettre_a_jour_Flame
/fr/docs/B2G_OS/Guide_Telephone_Developpeur/Fx0	/fr/docs/Archive/B2G_OS/Phone_guide/Fx0
/fr/docs/B2G_OS/Guide_Telephone_Developpeur/Huawei_Y300_II	/fr/docs/Archive/B2G_OS/Phone_guide/Huawei_Y300_II
/fr/docs/B2G_OS/Guide_Telephone_Developpeur/Intex_Cloud_FX	/fr/docs/Archive/B2G_OS/Phone_guide/Intex_Cloud_FX
/fr/docs/B2G_OS/Guide_Telephone_Developpeur/LG_fireweb	/fr/docs/Archive/B2G_OS/Phone_guide/LG_fireweb
/fr/docs/B2G_OS/Guide_Telephone_Developpeur/Nexus_4	/fr/docs/Archive/B2G_OS/Phone_guide/Nexus_4
/fr/docs/B2G_OS/Guide_Telephone_Developpeur/Nexus_5	/fr/docs/Archive/B2G_OS/Phone_guide/Nexus_5
/fr/docs/B2G_OS/Guide_Telephone_Developpeur/Phone_specs	/fr/docs/Archive/B2G_OS/Phone_guide/Phone_specs
/fr/docs/B2G_OS/Guide_Telephone_Developpeur/Spice_Fire_One_MI_FX1	/fr/docs/Archive/B2G_OS/Phone_guide/Spice_Fire_One_MI_FX1
/fr/docs/B2G_OS/Guide_Telephone_Developpeur/Spice_Fire_One_MI_FX2	/fr/docs/Archive/B2G_OS/Phone_guide/Spice_Fire_One_MI_FX2
/fr/docs/B2G_OS/Guide_Telephone_Developpeur/ZTE_OPEN	/fr/docs/Archive/B2G_OS/Phone_guide/ZTE_OPEN
/fr/docs/B2G_OS/Guide_Telephone_Developpeur/ZTE_OPEN_C	/fr/docs/Archive/B2G_OS/Phone_guide/ZTE_OPEN_C
/fr/docs/B2G_OS/Guide_Telephone_Developpeur/ZTE_Open_II	/fr/docs/Archive/B2G_OS/Phone_guide/ZTE_Open_II
/fr/docs/B2G_OS/Guide_Telephone_Developpeur/Zen_U105_Fire	/fr/docs/Archive/B2G_OS/Phone_guide/Zen_U105_Fire
/fr/docs/B2G_OS/Index	/fr/docs/Archive/B2G_OS/Index
/fr/docs/B2G_OS/Installer_sur_un_telephone_mobile	/fr/docs/Archive/B2G_OS/Installer_sur_un_telephone_mobile
/fr/docs/B2G_OS/Introduction	/fr/docs/Archive/B2G_OS/Introduction
/fr/docs/B2G_OS/Media_support	/fr/docs/Archive/B2G_OS/Media_support
/fr/docs/B2G_OS/Mulet	/fr/docs/Archive/B2G_OS/Mulet
/fr/docs/B2G_OS/Pandaboard	/fr/docs/Archive/B2G_OS/Pandaboard
/fr/docs/B2G_OS/Platform	/fr/docs/Archive/B2G_OS/Platform
/fr/docs/B2G_OS/Platform/Apps_architecture	/fr/docs/Archive/B2G_OS/Platform/Apps_architecture
/fr/docs/B2G_OS/Platform/Architecture	/fr/docs/Archive/B2G_OS/Platform/Architecture
/fr/docs/B2G_OS/Platform/Gaia	/fr/docs/Archive/B2G_OS/Platform/Gaia
/fr/docs/B2G_OS/Platform/Gaia/Gaia_apps	/fr/docs/Archive/B2G_OS/Platform/Gaia/Gaia_apps
/fr/docs/B2G_OS/Platform/Gaia/Gaia_apps/Browser	/fr/docs/Archive/B2G_OS/Platform/Gaia/Gaia_apps/Browser
/fr/docs/B2G_OS/Platform/Gaia/Gaia_apps/Paramètres	/fr/docs/Archive/B2G_OS/Platform/Gaia/Gaia_apps/Paramètres
/fr/docs/B2G_OS/Platform/Gaia/Gaia_apps/Système	/fr/docs/Archive/B2G_OS/Platform/Gaia/Gaia_apps/Système
/fr/docs/B2G_OS/Platform/Gaia/Gaia_apps/Video	/fr/docs/Archive/B2G_OS/Platform/Gaia/Gaia_apps/Video
/fr/docs/B2G_OS/Platform/Gaia/Hacking	/fr/docs/Archive/B2G_OS/Platform/Gaia/Hacking
/fr/docs/B2G_OS/Platform/Gaia/Introduction_a_Gaia	/fr/docs/Archive/B2G_OS/Platform/Gaia/Introduction_a_Gaia
/fr/docs/B2G_OS/Platform/Gestion_de_la_mémoire_dans_Firefox_OS	/fr/docs/Archive/B2G_OS/Platform/Gestion_de_la_mémoire_dans_Firefox_OS
/fr/docs/B2G_OS/Platform/Gonk	/fr/docs/Archive/B2G_OS/Platform/Gonk
/fr/docs/B2G_OS/Platform/Settings_list	/fr/docs/Archive/B2G_OS/Platform/Settings_list
/fr/docs/B2G_OS/Platform/support_fonctionnalites	/fr/docs/Archive/B2G_OS/Platform/support_fonctionnalites
/fr/docs/B2G_OS/Portage	/fr/docs/Archive/B2G_OS/Portage
/fr/docs/B2G_OS/Porter_Firefox_OS	/fr/docs/Archive/B2G_OS/Porter_Firefox_OS
/fr/docs/B2G_OS/Porter_Firefox_OS/B2G_Nexus_Player	/fr/docs/Archive/B2G_OS/Porter_Firefox_OS/B2G_Nexus_Player
/fr/docs/B2G_OS/Porter_Firefox_OS/Portage_sur_CyanogenMod	/fr/docs/Archive/B2G_OS/Porter_Firefox_OS/Portage_sur_CyanogenMod
/fr/docs/B2G_OS/Preparing_for_your_first_B2G_build	/fr/docs/Archive/B2G_OS/Preparing_for_your_first_B2G_build
/fr/docs/B2G_OS/Prerequis_pour_construire_Firefox_OS	/fr/docs/Archive/B2G_OS/Prerequis_pour_construire_Firefox_OS
/fr/docs/B2G_OS/Releases	/fr/docs/Archive/B2G_OS/Releases
/fr/docs/B2G_OS/Releases/1.0.1	/fr/docs/Archive/B2G_OS/Releases/1.0.1
/fr/docs/B2G_OS/Releases/1.1	/fr/docs/Archive/B2G_OS/Releases/1.1
/fr/docs/B2G_OS/Releases/2.0	/fr/docs/Archive/B2G_OS/Releases/2.0
/fr/docs/B2G_OS/Releases/2.1	/fr/docs/Archive/B2G_OS/Releases/2.1
/fr/docs/B2G_OS/Releases/2.2	/fr/docs/Archive/B2G_OS/Releases/2.2
/fr/docs/B2G_OS/Releases/2.5	/fr/docs/Archive/B2G_OS/Releases/2.5
/fr/docs/B2G_OS/Resources	/fr/docs/Archive/B2G_OS/Resources
/fr/docs/B2G_OS/Running_Tests_on_Firefox_OS_for_Developers	/fr/docs/Archive/B2G_OS/Running_Tests_on_Firefox_OS_for_Developers
/fr/docs/B2G_OS/Samsung_Nexus_S	/fr/docs/Archive/B2G_OS/Samsung_Nexus_S
/fr/docs/B2G_OS/Screencast_series:_App_Basics_for_Firefox_OS	/fr/docs/Archive/B2G_OS/Screencast_series:_App_Basics_for_Firefox_OS
/fr/docs/B2G_OS/Simulator_vs_Emulator_vs_Device	/fr/docs/Archive/B2G_OS/Simulator_vs_Emulator_vs_Device
/fr/docs/B2G_OS/Spark	/fr/docs/Archive/B2G_OS/Spark
/fr/docs/B2G_OS/Tips_and_tricks	/fr/docs/Archive/B2G_OS/Tips_and_tricks
/fr/docs/B2G_OS/Tips_and_tricks/Modifier_le_fichier_hosts	/fr/docs/Archive/B2G_OS/Tips_and_tricks/Modifier_le_fichier_hosts
/fr/docs/B2G_OS/Tips_and_tricks/faire_des_captures_ecran	/fr/docs/Archive/B2G_OS/Tips_and_tricks/faire_des_captures_ecran
/fr/docs/B2G_OS/UX	/fr/docs/Archive/B2G_OS/UX
/fr/docs/B2G_OS/Using_the_App_Manager	/fr/docs/Archive/B2G_OS/Using_the_App_Manager
/fr/docs/B2G_OS/Using_the_B2G_emulators	/fr/docs/Archive/B2G_OS/Using_the_B2G_emulators
/fr/docs/B2G_OS/Utiliser_Gaia_dans_Firefox	/fr/docs/Archive/B2G_OS/Utiliser_Gaia_dans_Firefox
/fr/docs/B2G_OS/Writing_apps_for_Boot_to_Gecko	/fr/docs/Archive/B2G_OS/Writing_apps_for_Boot_to_Gecko
/fr/docs/B2G_OS/depannage	/fr/docs/Archive/B2G_OS/depannage
/fr/docs/B2G_OS/securite	/fr/docs/Archive/B2G_OS/securite
/fr/docs/B2G_OS/securite/Application_security	/fr/docs/Archive/B2G_OS/securite/Application_security
/fr/docs/B2G_OS/securite/Installing_and_updating_applications	/fr/docs/Archive/B2G_OS/securite/Installing_and_updating_applications
/fr/docs/B2G_OS/securite/Security_model	/fr/docs/Archive/B2G_OS/securite/Security_model
/fr/docs/B2G_OS/securite/System_security	/fr/docs/Archive/B2G_OS/securite/System_security
/fr/docs/Bugzilla	/fr/docs/Mozilla/Bugzilla
/fr/docs/CSS/:-moz-tree-cell	/fr/docs/Mozilla/Gecko/Chrome/CSS/::-moz-tree-cell
/fr/docs/CSS/:-moz-tree-cell-text	/fr/docs/Mozilla/Gecko/Chrome/CSS/::-moz-tree-cell-text
/fr/docs/CSS/:-moz-tree-column	/fr/docs/Mozilla/Gecko/Chrome/CSS/::-moz-tree-column
/fr/docs/CSS/:-moz-tree-drop-feedback	/fr/docs/Mozilla/Gecko/Chrome/CSS/::-moz-tree-drop-feedback
/fr/docs/CSS/:-moz-tree-image	/fr/docs/Mozilla/Gecko/Chrome/CSS/::-moz-tree-image
/fr/docs/CSS/:-moz-tree-indentation	/fr/docs/Mozilla/Gecko/Chrome/CSS/::-moz-tree-indentation
/fr/docs/CSS/:-moz-tree-line	/fr/docs/Mozilla/Gecko/Chrome/CSS/::-moz-tree-line
/fr/docs/CSS/:-moz-tree-progressmeter	/fr/docs/Mozilla/Gecko/Chrome/CSS/::-moz-tree-progressmeter
/fr/docs/CSS/:-moz-tree-row	/fr/docs/Mozilla/Gecko/Chrome/CSS/::-moz-tree-row
/fr/docs/CSS/:-moz-tree-separator	/fr/docs/Mozilla/Gecko/Chrome/CSS/::-moz-tree-separator
/fr/docs/CSS/:-moz-tree-twisty	/fr/docs/Mozilla/Gecko/Chrome/CSS/::-moz-tree-twisty
/fr/docs/CSS/Problèmes_soulevés_par_le_pseudo_élément_hover	/fr/docs/Archive/Standards_du_Web/Problèmes_soulevés_par_le_pseudo_élément_hover
/fr/docs/CSS::-moz-tree-cell	/fr/docs/Mozilla/Gecko/Chrome/CSS/::-moz-tree-cell
/fr/docs/CSS::-moz-tree-cell-text	/fr/docs/Mozilla/Gecko/Chrome/CSS/::-moz-tree-cell-text
/fr/docs/CSS::-moz-tree-column	/fr/docs/Mozilla/Gecko/Chrome/CSS/::-moz-tree-column
/fr/docs/CSS::-moz-tree-drop-feedback	/fr/docs/Mozilla/Gecko/Chrome/CSS/::-moz-tree-drop-feedback
/fr/docs/CSS::-moz-tree-image	/fr/docs/Mozilla/Gecko/Chrome/CSS/::-moz-tree-image
/fr/docs/CSS::-moz-tree-indentation	/fr/docs/Mozilla/Gecko/Chrome/CSS/::-moz-tree-indentation
/fr/docs/CSS::-moz-tree-line	/fr/docs/Mozilla/Gecko/Chrome/CSS/::-moz-tree-line
/fr/docs/CSS::-moz-tree-progressmeter	/fr/docs/Mozilla/Gecko/Chrome/CSS/::-moz-tree-progressmeter
/fr/docs/CSS::-moz-tree-row	/fr/docs/Mozilla/Gecko/Chrome/CSS/::-moz-tree-row
/fr/docs/CSS::-moz-tree-separator	/fr/docs/Mozilla/Gecko/Chrome/CSS/::-moz-tree-separator
/fr/docs/CSS::-moz-tree-twisty	/fr/docs/Mozilla/Gecko/Chrome/CSS/::-moz-tree-twisty
/fr/docs/Caractères_internationaux_dans_du_JavaScript_XUL	/fr/docs/Archive/Mozilla/XUL/Caractères_internationaux_dans_du_JavaScript_XUL
/fr/docs/Choisir_de_se_conformer_aux_standards_plutôt_qu_aux_pratiques_propriétaires	/fr/docs/Archive/Standards_du_Web/Choisir_de_se_conformer_aux_standards_plutôt_qu_aux_pratiques_propriétaires
/fr/docs/Creer_un_theme	/fr/docs/Archive/Themes/Creer_un_theme
/fr/docs/Création_de_boutons_de_barre_d'outils	/fr/docs/Archive/Mozilla/XUL/Toolbars/Création_de_boutons_de_barre_d'outils
/fr/docs/DOM/App	/fr/docs/Archive/B2G_OS/API/DOMApplication
/fr/docs/DOM/Apps	/fr/docs/Archive/Marketplace/API/DOMApplicationsRegistry
/fr/docs/DOM/Apps.getInstalled	/fr/docs/Archive/Marketplace/API/DOMApplicationsRegistry/getInstalled
/fr/docs/DOM/Apps.getSelf	/fr/docs/Archive/Marketplace/API/DOMApplicationsRegistry/getSelf
/fr/docs/DOM/Apps.install	/fr/docs/Archive/Marketplace/API/DOMApplicationsRegistry/install
/fr/docs/DOM/DOMRequest	/fr/docs/Archive/B2G_OS/API/DOMRequest
/fr/docs/DOM/DOMRequest.error	/fr/docs/Archive/B2G_OS/API/DOMRequest/error
/fr/docs/DOM/DOMRequest.onerror	/fr/docs/Archive/B2G_OS/API/DOMRequest/onerror
/fr/docs/DOM/DOMRequest.onsuccess	/fr/docs/Archive/B2G_OS/API/DOMRequest/onsuccess
/fr/docs/DOM/DOMRequest.readyState	/fr/docs/Archive/B2G_OS/API/DOMRequest/readyState
/fr/docs/DOM/DOMRequest.result	/fr/docs/Archive/B2G_OS/API/DOMRequest/result
/fr/docs/DOM/window.navigator.mozApps	/fr/docs/Archive/B2G_OS/API/Navigator/mozApps
/fr/docs/Développement_de_modules_complémentaires	/fr/docs/Archive/Add-ons/Développement_de_modules_complémentaires
/fr/docs/Empaqueter_une_application_XUL	/fr/docs/Archive/Mozilla/XULRunner/Empaqueter_une_application_XUL
/fr/docs/FAQ_de_Mozilla_embarqué	/fr/docs/Gecko/Embedding_Mozilla/FAQ/How_do_I...
/fr/docs/FAQ_de_Mozilla_embarqué/Embarquer_Gecko	/fr/docs/Mozilla/Gecko/Mozilla_embarqué/FAQ_de_Mozilla_embarqué/Embarquer_Gecko
/fr/docs/FAQ_de_Mozilla_embarqué/Introduction_à_Gecko_et_à_l'embarqué	/fr/docs/Gecko/Mozilla_embarqué/FAQ_de_Mozilla_embarqué/Introduction_à_Gecko_et_à_l'embarqué
/fr/docs/FAQ_de_Mozilla_embarqué:Embarquer_Gecko	/fr/docs/Mozilla/Gecko/Mozilla_embarqué/FAQ_de_Mozilla_embarqué/Embarquer_Gecko
/fr/docs/FAQ_de_Mozilla_embarqué:Introduction_à_Gecko_et_à_l'embarqué	/fr/docs/Gecko/Mozilla_embarqué/FAQ_de_Mozilla_embarqué/Introduction_à_Gecko_et_à_l'embarqué
/fr/docs/FAQ_de_XULRunner	/fr/docs/Archive/Mozilla/XULRunner/FAQ_de_XULRunner
/fr/docs/FAQ_et_règles_pour_les_accesskeys_en_XUL	/fr/docs/Archive/Mozilla/XUL/FAQ_et_règles_pour_les_accesskeys_en_XUL
/fr/docs/FUEL/Window/deviceproximity	/fr/docs/Archive/deviceproximity
/fr/docs/Firefox_14_for_developers	/fr/docs/Mozilla/Firefox/Versions/14
/fr/docs/Florilège_des_applications_XULrunner	/fr/docs/Archive/Mozilla/XULRunner/Florilège_des_applications_XULrunner
/fr/docs/Gestion_de_suggestions_dans_les_plugins_de_recherche	/fr/docs/Archive/Add-ons/Gestion_de_suggestions_dans_les_plugins_de_recherche
/fr/docs/Guide_XUL_pour_les_gabarits_(externe)	/fr/docs/Archive/Mozilla/XUL/Tutoriel_XUL
/fr/docs/Icônes_de_fenêtre	/fr/docs/Archive/Mozilla/XUL/Icônes_de_fenêtre
/fr/docs/Images,_tableaux_et_décalages_mystérieux	/fr/docs/Archive/Misc_top_level/Images,_tableaux_et_décalages_mystérieux
/fr/docs/Installation_d'extensions_et_de_thèmes_depuis_une_page_Web	/fr/docs/Archive/Add-ons/Installation_d_extensions_et_de_thèmes_depuis_une_page_Web
/fr/docs/Introduction_à_XUL	/fr/docs/Archive/Mozilla/XUL/Introduction_à_XUL
/fr/docs/Intégration_de_l'éditeur	/fr/docs/Gecko/Mozilla_embarqué/Intégration_de_l'éditeur
/fr/docs/L10n_Style_Guide	/fr/docs/Mozilla/Localization/L10n_Style_Guide
/fr/docs/Le_modèle_économique_des_standards_Web	/fr/docs/Archive/Standards_du_Web/Le_modèle_économique_des_standards_Web
/fr/docs/Le_sniffing_de_DOCTYPE_dans_Mozilla	/fr/docs/Archive/Standards_du_Web/Le_sniffing_de_DOCTYPE_dans_Mozilla
/fr/docs/Les_contrôles_XUL	/fr/docs/Archive/Mozilla/XUL/Les_contrôles_XUL
/fr/docs/Les_joies_de_XUL	/fr/docs/Archive/Mozilla/XUL/Les_joies_de_XUL
/fr/docs/Les_états_de_contenu_et_le_système_de_style	/fr/docs/Archive/Mozilla/Firefox/Les_états_de_contenu_et_le_système_de_style
/fr/docs/Mobile	/fr/docs/Mozilla/Mobile
/fr/docs/Modification_dynamique_d'interfaces_utilisateur_en_XUL	/fr/docs/Archive/Mozilla/XUL/Modification_dynamique_d'interfaces_utilisateur_en_XUL
/fr/docs/Modifications_XUL_pour_Firefox_1.5	/fr/docs/Archive/Mozilla/XUL/Modifications_XUL_pour_Firefox_1.5
/fr/docs/Modifier_le_fichier_hosts	/fr/docs/Archive/B2G_OS/Tips_and_tricks/Modifier_le_fichier_hosts
/fr/docs/Modules_JavaScript	/fr/docs/Mozilla/JavaScript_code_modules
/fr/docs/Monitoring_WiFi_access_points	/fr/docs/Archive/Misc_top_level/Monitoring_WiFi_access_points
/fr/docs/Mozilla/Add-ons/Thèmes/Create_Your_Own_Firefox_Background_Theme	/fr/docs/Archive/Themes/Create_Your_Own_Firefox_Background_Theme
/fr/docs/Mozilla_Embedding_FAQ	/fr/docs/Gecko/Embedding_Mozilla/FAQ/How_do_I...
/fr/docs/Mozilla_embarqué	/fr/docs/Mozilla/Gecko/Mozilla_embarqué
/fr/docs/Mozilla_embarqué/API_overview	/fr/docs/Mozilla/Gecko/Mozilla_embarqué/API_overview
/fr/docs/Mozilla_embarqué/Communauté	/fr/docs/Mozilla/Gecko/Mozilla_embarqué
/fr/docs/Mozilla_embarqué:Communauté	/fr/docs/Mozilla/Gecko/Mozilla_embarqué
/fr/docs/NPAPI	/fr/docs/Mozilla/Add-ons/Plugins/Reference
/fr/docs/Notes_de_versions_de_XULRunner_1.8.0.4	/fr/docs/Archive/Mozilla/XULRunner/Notes_de_versions_de_XULRunner_1.8.0.4
/fr/docs/Notes_de_versions_de_XULRunner_1.9	/fr/docs/Archive/Mozilla/XULRunner/Notes_de_versions_de_XULRunner_1.9
/fr/docs/Nouveau_modèle_de_sécurité_des_services_Web	/fr/docs/Archive/Mozilla/Nouveau_modèle_de_sécurité_des_services_Web
/fr/docs/Outils/Firefox_OS_Simulator	/fr/docs/Archive/B2G_OS/Simulator
/fr/docs/Outils/Simulateur_Firefox_OS	/fr/docs/Archive/B2G_OS/Simulator
/fr/docs/Paquetage_multi_extensions	/fr/docs/Archive/Add-ons/Paquetage_multi_extensions
/fr/docs/Problèmes_soulevés_par_le_pseudo_élément_hover	/fr/docs/Archive/Standards_du_Web/Problèmes_soulevés_par_le_pseudo_élément_hover
/fr/docs/RDF_en_cinquante_mots	/fr/docs/Archive/Standards_du_Web/RDF_en_cinquante_mots
/fr/docs/RSS	/fr/docs/Archive/RSS
/fr/docs/RSS/Autres_ressources	/fr/docs/Archive/RSS/Autres_ressources
/fr/docs/RSS/Element	/fr/docs/Archive/RSS/Éléments
/fr/docs/RSS/Entités	/fr/docs/Archive/RSS/Entités
/fr/docs/RSS/Premiers_pas	/fr/docs/Archive/RSS/Premiers_pas
/fr/docs/RSS/Premiers_pas/Fonctionnement_de_RSS	/fr/docs/Archive/RSS/Premiers_pas/Fonctionnement_de_RSS
/fr/docs/RSS/Premiers_pas/Pourquoi_utiliser_RSS	/fr/docs/Archive/RSS/Premiers_pas/Pourquoi_utiliser_RSS
/fr/docs/RSS/Premiers_pas/Présentation_de_RSS	/fr/docs/Archive/RSS/Premiers_pas/Présentation_de_RSS
/fr/docs/RSS/Premiers_pas/Syndication	/fr/docs/Archive/RSS/Premiers_pas/Syndication
/fr/docs/RSS/Version	/fr/docs/Archive/RSS/Version
/fr/docs/RSS/entity	/fr/docs/Archive/RSS/Entités
/fr/docs/RSS/Éléments	/fr/docs/Archive/RSS/Éléments
/fr/docs/RSS:Autres_ressources	/fr/docs/Archive/RSS/Autres_ressources
/fr/docs/RSS:Element	/fr/docs/Archive/RSS/Éléments
/fr/docs/RSS:Entités	/fr/docs/Archive/RSS/Entités
/fr/docs/RSS:Premiers_pas	/fr/docs/Archive/RSS/Premiers_pas
/fr/docs/RSS:Premiers_pas:Fonctionnement_de_RSS	/fr/docs/Archive/RSS/Premiers_pas/Fonctionnement_de_RSS
/fr/docs/RSS:Premiers_pas:Pourquoi_utiliser_RSS	/fr/docs/Archive/RSS/Premiers_pas/Pourquoi_utiliser_RSS
/fr/docs/RSS:Premiers_pas:Présentation_de_RSS	/fr/docs/Archive/RSS/Premiers_pas/Présentation_de_RSS
/fr/docs/RSS:Premiers_pas:Syndication	/fr/docs/Archive/RSS/Premiers_pas/Syndication
/fr/docs/RSS:Version	/fr/docs/Archive/RSS/Version
/fr/docs/RSS:entity	/fr/docs/Archive/RSS/Entités
/fr/docs/RSS:Éléments	/fr/docs/Archive/RSS/Éléments
/fr/docs/Recommandations_accessibilité_pour_XUL	/fr/docs/Archive/Mozilla/XUL/Recommandations_accessibilité_pour_XUL
/fr/docs/Rhino	/fr/docs/Mozilla/Projects/Rhino
/fr/docs/Rhino/Examples	/fr/docs/Mozilla/Projects/Rhino/Examples
/fr/docs/Référence_XUL	/fr/docs/Archive/Mozilla/XUL/Référence_XUL
/fr/docs/Référence_de_l'API_XPInstall	/fr/docs/Archive/Mozilla/XPInstall/Référence_de_l_API_XPInstall
/fr/docs/Référence_de_l'API_XPInstall/Codes_retournés	/fr/docs/Archive/Mozilla/XPInstall/Référence_de_l_API_XPInstall/Codes_retournés
/fr/docs/Référence_de_l'API_XPInstall/Exemples	/fr/docs/Archive/Mozilla/XPInstall/Référence_de_l_API_XPInstall/Exemples
/fr/docs/Référence_de_l'API_XPInstall/Exemples/File.macAlias	/fr/docs/Archive/Mozilla/XPInstall/Référence_de_l_API_XPInstall/Exemples/File.macAlias
/fr/docs/Référence_de_l'API_XPInstall/Exemples/File.windowsShortcut	/fr/docs/Archive/Mozilla/XPInstall/Référence_de_l_API_XPInstall/Exemples/File.windowsShortcut
/fr/docs/Référence_de_l'API_XPInstall/Exemples/Install.addDirectory	/fr/docs/Archive/Mozilla/XPInstall/Référence_de_l_API_XPInstall/Exemples/Install.addDirectory
/fr/docs/Référence_de_l'API_XPInstall/Exemples/Install.addFile	/fr/docs/Archive/Mozilla/XPInstall/Référence_de_l_API_XPInstall/Exemples/Install.addFile
/fr/docs/Référence_de_l'API_XPInstall/Exemples/InstallTrigger.installChrome	/fr/docs/Archive/Mozilla/XPInstall/Référence_de_l_API_XPInstall/Exemples/InstallTrigger.installChrome
/fr/docs/Référence_de_l'API_XPInstall/Exemples/InstallTrigger.startSoftwareUpdate	/fr/docs/Archive/Mozilla/XPInstall/Référence_de_l_API_XPInstall/Exemples/InstallTrigger.startSoftwareUpdate
/fr/docs/Référence_de_l'API_XPInstall/Exemples/Scripts_de_déclenchement_et_scripts_d'installation	/fr/docs/Archive/Mozilla/XPInstall/Référence_de_l_API_XPInstall/Exemples/Scripts_de_déclenchement_et_scripts_d'installation
/fr/docs/Référence_de_l'API_XPInstall/Exemples/Windows_Install	/fr/docs/Archive/Mozilla/XPInstall/Référence_de_l_API_XPInstall/Exemples/Windows_Install
/fr/docs/Référence_de_l'API_XPInstall/Objet_File	/fr/docs/Archive/Mozilla/XPInstall/Référence_de_l_API_XPInstall/Objet_File
/fr/docs/Référence_de_l'API_XPInstall/Objet_File/Méthodes	/fr/docs/Archive/Mozilla/XPInstall/Référence_de_l_API_XPInstall/Objet_File/Méthodes
/fr/docs/Référence_de_l'API_XPInstall/Objet_File/Méthodes/copy	/fr/docs/Archive/Mozilla/XPInstall/Référence_de_l_API_XPInstall/Objet_File/Méthodes/copy
/fr/docs/Référence_de_l'API_XPInstall/Objet_File/Méthodes/dirCreate	/fr/docs/Archive/Mozilla/XPInstall/Référence_de_l_API_XPInstall/Objet_File/Méthodes/dirCreate
/fr/docs/Référence_de_l'API_XPInstall/Objet_File/Méthodes/dirGetParent	/fr/docs/Archive/Mozilla/XPInstall/Référence_de_l_API_XPInstall/Objet_File/Méthodes/dirGetParent
/fr/docs/Référence_de_l'API_XPInstall/Objet_File/Méthodes/dirRemove	/fr/docs/Archive/Mozilla/XPInstall/Référence_de_l_API_XPInstall/Objet_File/Méthodes/dirRemove
/fr/docs/Référence_de_l'API_XPInstall/Objet_File/Méthodes/dirRename	/fr/docs/Archive/Mozilla/XPInstall/Référence_de_l_API_XPInstall/Objet_File/Méthodes/dirRename
/fr/docs/Référence_de_l'API_XPInstall/Objet_File/Méthodes/diskSpaceAvailable	/fr/docs/Archive/Mozilla/XPInstall/Référence_de_l_API_XPInstall/Objet_File/Méthodes/diskSpaceAvailable
/fr/docs/Référence_de_l'API_XPInstall/Objet_File/Méthodes/execute	/fr/docs/Archive/Mozilla/XPInstall/Référence_de_l_API_XPInstall/Objet_File/Méthodes/execute
/fr/docs/Référence_de_l'API_XPInstall/Objet_File/Méthodes/exists	/fr/docs/Archive/Mozilla/XPInstall/Référence_de_l_API_XPInstall/Objet_File/Méthodes/exists
/fr/docs/Référence_de_l'API_XPInstall/Objet_File/Méthodes/isDirectory	/fr/docs/Archive/Mozilla/XPInstall/Référence_de_l_API_XPInstall/Objet_File/Méthodes/isDirectory
/fr/docs/Référence_de_l'API_XPInstall/Objet_File/Méthodes/isFile	/fr/docs/Archive/Mozilla/XPInstall/Référence_de_l_API_XPInstall/Objet_File/Méthodes/isFile
/fr/docs/Référence_de_l'API_XPInstall/Objet_File/Méthodes/macAlias	/fr/docs/Archive/Mozilla/XPInstall/Référence_de_l_API_XPInstall/Objet_File/Méthodes/macAlias
/fr/docs/Référence_de_l'API_XPInstall/Objet_File/Méthodes/modDate	/fr/docs/Archive/Mozilla/XPInstall/Référence_de_l_API_XPInstall/Objet_File/Méthodes/modDate
/fr/docs/Référence_de_l'API_XPInstall/Objet_File/Méthodes/modDateChanged	/fr/docs/Archive/Mozilla/XPInstall/Référence_de_l_API_XPInstall/Objet_File/Méthodes/modDateChanged
/fr/docs/Référence_de_l'API_XPInstall/Objet_File/Méthodes/move	/fr/docs/Archive/Mozilla/XPInstall/Référence_de_l_API_XPInstall/Objet_File/Méthodes/move
/fr/docs/Référence_de_l'API_XPInstall/Objet_File/Méthodes/remove	/fr/docs/Archive/Mozilla/XPInstall/Référence_de_l_API_XPInstall/Objet_File/Méthodes/remove
/fr/docs/Référence_de_l'API_XPInstall/Objet_File/Méthodes/rename	/fr/docs/Archive/Mozilla/XPInstall/Référence_de_l_API_XPInstall/Objet_File/Méthodes/rename
/fr/docs/Référence_de_l'API_XPInstall/Objet_File/Méthodes/size	/fr/docs/Archive/Mozilla/XPInstall/Référence_de_l_API_XPInstall/Objet_File/Méthodes/size
/fr/docs/Référence_de_l'API_XPInstall/Objet_File/Méthodes/windowsGetShortName	/fr/docs/Archive/Mozilla/XPInstall/Référence_de_l_API_XPInstall/Objet_File/Méthodes/windowsGetShortName
/fr/docs/Référence_de_l'API_XPInstall/Objet_File/Méthodes/windowsRegisterServer	/fr/docs/Archive/Mozilla/XPInstall/Référence_de_l_API_XPInstall/Objet_File/Méthodes/windowsRegisterServer
/fr/docs/Référence_de_l'API_XPInstall/Objet_File/Méthodes/windowsShortcut	/fr/docs/Archive/Mozilla/XPInstall/Référence_de_l_API_XPInstall/Objet_File/Méthodes/windowsShortcut
/fr/docs/Référence_de_l'API_XPInstall/Objet_Install	/fr/docs/Archive/Mozilla/XPInstall/Référence_de_l_API_XPInstall/Objet_Install
/fr/docs/Référence_de_l'API_XPInstall/Objet_Install/Méthodes	/fr/docs/Archive/Mozilla/XPInstall/Référence_de_l_API_XPInstall/Objet_Install/Méthodes
/fr/docs/Référence_de_l'API_XPInstall/Objet_Install/Méthodes/addDirectory	/fr/docs/Archive/Mozilla/XPInstall/Référence_de_l_API_XPInstall/Objet_Install/Méthodes/addDirectory
/fr/docs/Référence_de_l'API_XPInstall/Objet_Install/Méthodes/addFile	/fr/docs/Archive/Mozilla/XPInstall/Référence_de_l_API_XPInstall/Objet_Install/Méthodes/addFile
/fr/docs/Référence_de_l'API_XPInstall/Objet_Install/Méthodes/alert	/fr/docs/Archive/Mozilla/XPInstall/Référence_de_l_API_XPInstall/Objet_Install/Méthodes/alert
/fr/docs/Référence_de_l'API_XPInstall/Objet_Install/Méthodes/cancelInstall	/fr/docs/Archive/Mozilla/XPInstall/Référence_de_l_API_XPInstall/Objet_Install/Méthodes/cancelInstall
/fr/docs/Référence_de_l'API_XPInstall/Objet_Install/Méthodes/confirm	/fr/docs/Archive/Mozilla/XPInstall/Référence_de_l_API_XPInstall/Objet_Install/Méthodes/confirm
/fr/docs/Référence_de_l'API_XPInstall/Objet_Install/Méthodes/deleteRegisteredFile	/fr/docs/Archive/Mozilla/XPInstall/Référence_de_l_API_XPInstall/Objet_Install/Méthodes/deleteRegisteredFile
/fr/docs/Référence_de_l'API_XPInstall/Objet_Install/Méthodes/execute	/fr/docs/Archive/Mozilla/XPInstall/Référence_de_l_API_XPInstall/Objet_Install/Méthodes/execute
/fr/docs/Référence_de_l'API_XPInstall/Objet_Install/Méthodes/gestalt	/fr/docs/Archive/Mozilla/XPInstall/Référence_de_l_API_XPInstall/Objet_Install/Méthodes/gestalt
/fr/docs/Référence_de_l'API_XPInstall/Objet_Install/Méthodes/getComponentFolder	/fr/docs/Archive/Mozilla/XPInstall/Référence_de_l_API_XPInstall/Objet_Install/Méthodes/getComponentFolder
/fr/docs/Référence_de_l'API_XPInstall/Objet_Install/Méthodes/getFolder	/fr/docs/Archive/Mozilla/XPInstall/Référence_de_l_API_XPInstall/Objet_Install/Méthodes/getFolder
/fr/docs/Référence_de_l'API_XPInstall/Objet_Install/Méthodes/getLastError	/fr/docs/Archive/Mozilla/XPInstall/Référence_de_l_API_XPInstall/Objet_Install/Méthodes/getLastError
/fr/docs/Référence_de_l'API_XPInstall/Objet_Install/Méthodes/getWinProfile	/fr/docs/Archive/Mozilla/XPInstall/Référence_de_l_API_XPInstall/Objet_Install/Méthodes/getWinProfile
/fr/docs/Référence_de_l'API_XPInstall/Objet_Install/Méthodes/getWinRegistry	/fr/docs/Archive/Mozilla/XPInstall/Référence_de_l_API_XPInstall/Objet_Install/Méthodes/getWinRegistry
/fr/docs/Référence_de_l'API_XPInstall/Objet_Install/Méthodes/initInstall	/fr/docs/Archive/Mozilla/XPInstall/Référence_de_l_API_XPInstall/Objet_Install/Méthodes/initInstall
/fr/docs/Référence_de_l'API_XPInstall/Objet_Install/Méthodes/loadResources	/fr/docs/Archive/Mozilla/XPInstall/Référence_de_l_API_XPInstall/Objet_Install/Méthodes/loadResources
/fr/docs/Référence_de_l'API_XPInstall/Objet_Install/Méthodes/logComment	/fr/docs/Archive/Mozilla/XPInstall/Référence_de_l_API_XPInstall/Objet_Install/Méthodes/logComment
/fr/docs/Référence_de_l'API_XPInstall/Objet_Install/Méthodes/patch	/fr/docs/Archive/Mozilla/XPInstall/Référence_de_l_API_XPInstall/Objet_Install/Méthodes/patch
/fr/docs/Référence_de_l'API_XPInstall/Objet_Install/Méthodes/performInstall	/fr/docs/Archive/Mozilla/XPInstall/Référence_de_l_API_XPInstall/Objet_Install/Méthodes/performInstall
/fr/docs/Référence_de_l'API_XPInstall/Objet_Install/Méthodes/refreshPlugins	/fr/docs/Archive/Mozilla/XPInstall/Référence_de_l_API_XPInstall/Objet_Install/Méthodes/refreshPlugins
/fr/docs/Référence_de_l'API_XPInstall/Objet_Install/Méthodes/registerChrome	/fr/docs/Archive/Mozilla/XPInstall/Référence_de_l_API_XPInstall/Objet_Install/Méthodes/registerChrome
/fr/docs/Référence_de_l'API_XPInstall/Objet_Install/Méthodes/resetError	/fr/docs/Archive/Mozilla/XPInstall/Référence_de_l_API_XPInstall/Objet_Install/Méthodes/resetError
/fr/docs/Référence_de_l'API_XPInstall/Objet_Install/Méthodes/setPackageFolder	/fr/docs/Archive/Mozilla/XPInstall/Référence_de_l_API_XPInstall/Objet_Install/Méthodes/setPackageFolder
/fr/docs/Référence_de_l'API_XPInstall/Objet_Install/Propriétés	/fr/docs/Archive/Mozilla/XPInstall/Référence_de_l_API_XPInstall/Objet_Install/Propriétés
/fr/docs/Référence_de_l'API_XPInstall/Objet_InstallTrigger	/fr/docs/Archive/Mozilla/XPInstall/Référence_de_l_API_XPInstall/Objet_InstallTrigger
/fr/docs/Référence_de_l'API_XPInstall/Objet_InstallVersion	/fr/docs/Archive/Mozilla/XPInstall/Référence_de_l_API_XPInstall/Objet_InstallVersion
/fr/docs/Référence_de_l'API_XPInstall/Objet_InstallVersion/Méthodes	/fr/docs/Archive/Mozilla/XPInstall/Référence_de_l_API_XPInstall/Objet_InstallVersion/Méthodes
/fr/docs/Référence_de_l'API_XPInstall/Objet_InstallVersion/Méthodes/compareTo	/fr/docs/Archive/Mozilla/XPInstall/Référence_de_l_API_XPInstall/Objet_InstallVersion/Méthodes/compareTo
/fr/docs/Référence_de_l'API_XPInstall/Objet_InstallVersion/Méthodes/init	/fr/docs/Archive/Mozilla/XPInstall/Référence_de_l_API_XPInstall/Objet_InstallVersion/Méthodes/init
/fr/docs/Référence_de_l'API_XPInstall/Objet_InstallVersion/Méthodes/toString	/fr/docs/Archive/Mozilla/XPInstall/Référence_de_l_API_XPInstall/Objet_InstallVersion/Méthodes/toString
/fr/docs/Référence_de_l'API_XPInstall/Objet_InstallVersion/Propriétés	/fr/docs/Archive/Mozilla/XPInstall/Référence_de_l_API_XPInstall/Objet_InstallVersion/Propriétés
/fr/docs/Référence_de_l'API_XPInstall/Objet_WinProfile	/fr/docs/Archive/Mozilla/XPInstall/Référence_de_l_API_XPInstall/Objet_WinProfile
/fr/docs/Référence_de_l'API_XPInstall/Objet_WinProfile/Méthodes	/fr/docs/Archive/Mozilla/XPInstall/Référence_de_l_API_XPInstall/Objet_WinProfile/Méthodes
/fr/docs/Référence_de_l'API_XPInstall/Objet_WinProfile/Méthodes/getString	/fr/docs/Archive/Mozilla/XPInstall/Référence_de_l_API_XPInstall/Objet_WinProfile/Méthodes/getString
/fr/docs/Référence_de_l'API_XPInstall/Objet_WinProfile/Méthodes/writeString	/fr/docs/Archive/Mozilla/XPInstall/Référence_de_l_API_XPInstall/Objet_WinProfile/Méthodes/writeString
/fr/docs/Référence_de_l'API_XPInstall/Objet_WinReg	/fr/docs/Archive/Mozilla/XPInstall/Référence_de_l_API_XPInstall/Objet_WinReg
/fr/docs/Référence_de_l'API_XPInstall/Objet_WinReg/Méthodes	/fr/docs/Archive/Mozilla/XPInstall/Référence_de_l_API_XPInstall/Objet_WinReg/Méthodes
/fr/docs/Référence_de_l'API_XPInstall/Objet_WinReg/Méthodes/createKey	/fr/docs/Archive/Mozilla/XPInstall/Référence_de_l_API_XPInstall/Objet_WinReg/Méthodes/createKey
/fr/docs/Référence_de_l'API_XPInstall/Objet_WinReg/Méthodes/deleteKey	/fr/docs/Archive/Mozilla/XPInstall/Référence_de_l_API_XPInstall/Objet_WinReg/Méthodes/deleteKey
/fr/docs/Référence_de_l'API_XPInstall/Objet_WinReg/Méthodes/deleteValue	/fr/docs/Archive/Mozilla/XPInstall/Référence_de_l_API_XPInstall/Objet_WinReg/Méthodes/deleteValue
/fr/docs/Référence_de_l'API_XPInstall/Objet_WinReg/Méthodes/enumKeys	/fr/docs/Archive/Mozilla/XPInstall/Référence_de_l_API_XPInstall/Objet_WinReg/Méthodes/enumKeys
/fr/docs/Référence_de_l'API_XPInstall/Objet_WinReg/Méthodes/enumValueNames	/fr/docs/Archive/Mozilla/XPInstall/Référence_de_l_API_XPInstall/Objet_WinReg/Méthodes/enumValueNames
/fr/docs/Référence_de_l'API_XPInstall/Objet_WinReg/Méthodes/getValue	/fr/docs/Archive/Mozilla/XPInstall/Référence_de_l_API_XPInstall/Objet_WinReg/Méthodes/getValue
/fr/docs/Référence_de_l'API_XPInstall/Objet_WinReg/Méthodes/getValueNumber	/fr/docs/Archive/Mozilla/XPInstall/Référence_de_l_API_XPInstall/Objet_WinReg/Méthodes/getValueNumber
/fr/docs/Référence_de_l'API_XPInstall/Objet_WinReg/Méthodes/getValueString	/fr/docs/Archive/Mozilla/XPInstall/Référence_de_l_API_XPInstall/Objet_WinReg/Méthodes/getValueString
/fr/docs/Référence_de_l'API_XPInstall/Objet_WinReg/Méthodes/isKeyWritable	/fr/docs/Archive/Mozilla/XPInstall/Référence_de_l_API_XPInstall/Objet_WinReg/Méthodes/isKeyWritable
/fr/docs/Référence_de_l'API_XPInstall/Objet_WinReg/Méthodes/keyExists	/fr/docs/Archive/Mozilla/XPInstall/Référence_de_l_API_XPInstall/Objet_WinReg/Méthodes/keyExists
/fr/docs/Référence_de_l'API_XPInstall/Objet_WinReg/Méthodes/setRootKey	/fr/docs/Archive/Mozilla/XPInstall/Référence_de_l_API_XPInstall/Objet_WinReg/Méthodes/setRootKey
/fr/docs/Référence_de_l'API_XPInstall/Objet_WinReg/Méthodes/setValue	/fr/docs/Archive/Mozilla/XPInstall/Référence_de_l_API_XPInstall/Objet_WinReg/Méthodes/setValue
/fr/docs/Référence_de_l'API_XPInstall/Objet_WinReg/Méthodes/setValueNumber	/fr/docs/Archive/Mozilla/XPInstall/Référence_de_l_API_XPInstall/Objet_WinReg/Méthodes/setValueNumber
/fr/docs/Référence_de_l'API_XPInstall/Objet_WinReg/Méthodes/setValueString	/fr/docs/Archive/Mozilla/XPInstall/Référence_de_l_API_XPInstall/Objet_WinReg/Méthodes/setValueString
/fr/docs/Référence_de_l'API_XPInstall/Objet_WinReg/Méthodes/valueExists	/fr/docs/Archive/Mozilla/XPInstall/Référence_de_l_API_XPInstall/Objet_WinReg/Méthodes/valueExists
/fr/docs/Référence_de_l'API_XPInstall/Objet_WinReg/WinRegValue	/fr/docs/Archive/Mozilla/XPInstall/Référence_de_l_API_XPInstall/Objet_WinReg/WinRegValue
/fr/docs/Référence_de_l'API_XPInstall:Codes_retournés	/fr/docs/Archive/Mozilla/XPInstall/Référence_de_l_API_XPInstall/Codes_retournés
/fr/docs/Référence_de_l'API_XPInstall:Exemples:File.macAlias	/fr/docs/Archive/Mozilla/XPInstall/Référence_de_l_API_XPInstall/Exemples/File.macAlias
/fr/docs/Référence_de_l'API_XPInstall:Exemples:File.windowsShortcut	/fr/docs/Archive/Mozilla/XPInstall/Référence_de_l_API_XPInstall/Exemples/File.windowsShortcut
/fr/docs/Référence_de_l'API_XPInstall:Exemples:Install.addDirectory	/fr/docs/Archive/Mozilla/XPInstall/Référence_de_l_API_XPInstall/Exemples/Install.addDirectory
/fr/docs/Référence_de_l'API_XPInstall:Exemples:Install.addFile	/fr/docs/Archive/Mozilla/XPInstall/Référence_de_l_API_XPInstall/Exemples/Install.addFile
/fr/docs/Référence_de_l'API_XPInstall:Exemples:InstallTrigger.installChrome	/fr/docs/Archive/Mozilla/XPInstall/Référence_de_l_API_XPInstall/Exemples/InstallTrigger.installChrome
/fr/docs/Référence_de_l'API_XPInstall:Exemples:InstallTrigger.startSoftwareUpdate	/fr/docs/Archive/Mozilla/XPInstall/Référence_de_l_API_XPInstall/Exemples/InstallTrigger.startSoftwareUpdate
/fr/docs/Référence_de_l'API_XPInstall:Exemples:Scripts_de_déclenchement_et_scripts_d'installation	/fr/docs/Archive/Mozilla/XPInstall/Référence_de_l_API_XPInstall/Exemples/Scripts_de_déclenchement_et_scripts_d'installation
/fr/docs/Référence_de_l'API_XPInstall:Exemples:Windows_Install	/fr/docs/Archive/Mozilla/XPInstall/Référence_de_l_API_XPInstall/Exemples/Windows_Install
/fr/docs/Référence_de_l'API_XPInstall:Objet_File	/fr/docs/Archive/Mozilla/XPInstall/Référence_de_l_API_XPInstall/Objet_File
/fr/docs/Référence_de_l'API_XPInstall:Objet_File:Méthodes	/fr/docs/Archive/Mozilla/XPInstall/Référence_de_l_API_XPInstall/Objet_File/Méthodes
/fr/docs/Référence_de_l'API_XPInstall:Objet_File:Méthodes:copy	/fr/docs/Archive/Mozilla/XPInstall/Référence_de_l_API_XPInstall/Objet_File/Méthodes/copy
/fr/docs/Référence_de_l'API_XPInstall:Objet_File:Méthodes:dirCreate	/fr/docs/Archive/Mozilla/XPInstall/Référence_de_l_API_XPInstall/Objet_File/Méthodes/dirCreate
/fr/docs/Référence_de_l'API_XPInstall:Objet_File:Méthodes:dirGetParent	/fr/docs/Archive/Mozilla/XPInstall/Référence_de_l_API_XPInstall/Objet_File/Méthodes/dirGetParent
/fr/docs/Référence_de_l'API_XPInstall:Objet_File:Méthodes:dirRemove	/fr/docs/Archive/Mozilla/XPInstall/Référence_de_l_API_XPInstall/Objet_File/Méthodes/dirRemove
/fr/docs/Référence_de_l'API_XPInstall:Objet_File:Méthodes:dirRename	/fr/docs/Archive/Mozilla/XPInstall/Référence_de_l_API_XPInstall/Objet_File/Méthodes/dirRename
/fr/docs/Référence_de_l'API_XPInstall:Objet_File:Méthodes:diskSpaceAvailable	/fr/docs/Archive/Mozilla/XPInstall/Référence_de_l_API_XPInstall/Objet_File/Méthodes/diskSpaceAvailable
/fr/docs/Référence_de_l'API_XPInstall:Objet_File:Méthodes:execute	/fr/docs/Archive/Mozilla/XPInstall/Référence_de_l_API_XPInstall/Objet_File/Méthodes/execute
/fr/docs/Référence_de_l'API_XPInstall:Objet_File:Méthodes:exists	/fr/docs/Archive/Mozilla/XPInstall/Référence_de_l_API_XPInstall/Objet_File/Méthodes/exists
/fr/docs/Référence_de_l'API_XPInstall:Objet_File:Méthodes:isDirectory	/fr/docs/Archive/Mozilla/XPInstall/Référence_de_l_API_XPInstall/Objet_File/Méthodes/isDirectory
/fr/docs/Référence_de_l'API_XPInstall:Objet_File:Méthodes:isFile	/fr/docs/Archive/Mozilla/XPInstall/Référence_de_l_API_XPInstall/Objet_File/Méthodes/isFile
/fr/docs/Référence_de_l'API_XPInstall:Objet_File:Méthodes:macAlias	/fr/docs/Archive/Mozilla/XPInstall/Référence_de_l_API_XPInstall/Objet_File/Méthodes/macAlias
/fr/docs/Référence_de_l'API_XPInstall:Objet_File:Méthodes:modDate	/fr/docs/Archive/Mozilla/XPInstall/Référence_de_l_API_XPInstall/Objet_File/Méthodes/modDate
/fr/docs/Référence_de_l'API_XPInstall:Objet_File:Méthodes:modDateChanged	/fr/docs/Archive/Mozilla/XPInstall/Référence_de_l_API_XPInstall/Objet_File/Méthodes/modDateChanged
/fr/docs/Référence_de_l'API_XPInstall:Objet_File:Méthodes:move	/fr/docs/Archive/Mozilla/XPInstall/Référence_de_l_API_XPInstall/Objet_File/Méthodes/move
/fr/docs/Référence_de_l'API_XPInstall:Objet_File:Méthodes:remove	/fr/docs/Archive/Mozilla/XPInstall/Référence_de_l_API_XPInstall/Objet_File/Méthodes/remove
/fr/docs/Référence_de_l'API_XPInstall:Objet_File:Méthodes:rename	/fr/docs/Archive/Mozilla/XPInstall/Référence_de_l_API_XPInstall/Objet_File/Méthodes/rename
/fr/docs/Référence_de_l'API_XPInstall:Objet_File:Méthodes:size	/fr/docs/Archive/Mozilla/XPInstall/Référence_de_l_API_XPInstall/Objet_File/Méthodes/size
/fr/docs/Référence_de_l'API_XPInstall:Objet_File:Méthodes:windowsGetShortName	/fr/docs/Archive/Mozilla/XPInstall/Référence_de_l_API_XPInstall/Objet_File/Méthodes/windowsGetShortName
/fr/docs/Référence_de_l'API_XPInstall:Objet_File:Méthodes:windowsRegisterServer	/fr/docs/Archive/Mozilla/XPInstall/Référence_de_l_API_XPInstall/Objet_File/Méthodes/windowsRegisterServer
/fr/docs/Référence_de_l'API_XPInstall:Objet_File:Méthodes:windowsShortcut	/fr/docs/Archive/Mozilla/XPInstall/Référence_de_l_API_XPInstall/Objet_File/Méthodes/windowsShortcut
/fr/docs/Référence_de_l'API_XPInstall:Objet_Install	/fr/docs/Archive/Mozilla/XPInstall/Référence_de_l_API_XPInstall/Objet_Install
/fr/docs/Référence_de_l'API_XPInstall:Objet_Install:Méthodes	/fr/docs/Archive/Mozilla/XPInstall/Référence_de_l_API_XPInstall/Objet_Install/Méthodes
/fr/docs/Référence_de_l'API_XPInstall:Objet_Install:Méthodes:addDirectory	/fr/docs/Archive/Mozilla/XPInstall/Référence_de_l_API_XPInstall/Objet_Install/Méthodes/addDirectory
/fr/docs/Référence_de_l'API_XPInstall:Objet_Install:Méthodes:addFile	/fr/docs/Archive/Mozilla/XPInstall/Référence_de_l_API_XPInstall/Objet_Install/Méthodes/addFile
/fr/docs/Référence_de_l'API_XPInstall:Objet_Install:Méthodes:alert	/fr/docs/Archive/Mozilla/XPInstall/Référence_de_l_API_XPInstall/Objet_Install/Méthodes/alert
/fr/docs/Référence_de_l'API_XPInstall:Objet_Install:Méthodes:cancelInstall	/fr/docs/Archive/Mozilla/XPInstall/Référence_de_l_API_XPInstall/Objet_Install/Méthodes/cancelInstall
/fr/docs/Référence_de_l'API_XPInstall:Objet_Install:Méthodes:confirm	/fr/docs/Archive/Mozilla/XPInstall/Référence_de_l_API_XPInstall/Objet_Install/Méthodes/confirm
/fr/docs/Référence_de_l'API_XPInstall:Objet_Install:Méthodes:deleteRegisteredFile	/fr/docs/Archive/Mozilla/XPInstall/Référence_de_l_API_XPInstall/Objet_Install/Méthodes/deleteRegisteredFile
/fr/docs/Référence_de_l'API_XPInstall:Objet_Install:Méthodes:execute	/fr/docs/Archive/Mozilla/XPInstall/Référence_de_l_API_XPInstall/Objet_Install/Méthodes/execute
/fr/docs/Référence_de_l'API_XPInstall:Objet_Install:Méthodes:gestalt	/fr/docs/Archive/Mozilla/XPInstall/Référence_de_l_API_XPInstall/Objet_Install/Méthodes/gestalt
/fr/docs/Référence_de_l'API_XPInstall:Objet_Install:Méthodes:getComponentFolder	/fr/docs/Archive/Mozilla/XPInstall/Référence_de_l_API_XPInstall/Objet_Install/Méthodes/getComponentFolder
/fr/docs/Référence_de_l'API_XPInstall:Objet_Install:Méthodes:getFolder	/fr/docs/Archive/Mozilla/XPInstall/Référence_de_l_API_XPInstall/Objet_Install/Méthodes/getFolder
/fr/docs/Référence_de_l'API_XPInstall:Objet_Install:Méthodes:getLastError	/fr/docs/Archive/Mozilla/XPInstall/Référence_de_l_API_XPInstall/Objet_Install/Méthodes/getLastError
/fr/docs/Référence_de_l'API_XPInstall:Objet_Install:Méthodes:getWinProfile	/fr/docs/Archive/Mozilla/XPInstall/Référence_de_l_API_XPInstall/Objet_Install/Méthodes/getWinProfile
/fr/docs/Référence_de_l'API_XPInstall:Objet_Install:Méthodes:getWinRegistry	/fr/docs/Archive/Mozilla/XPInstall/Référence_de_l_API_XPInstall/Objet_Install/Méthodes/getWinRegistry
/fr/docs/Référence_de_l'API_XPInstall:Objet_Install:Méthodes:initInstall	/fr/docs/Archive/Mozilla/XPInstall/Référence_de_l_API_XPInstall/Objet_Install/Méthodes/initInstall
/fr/docs/Référence_de_l'API_XPInstall:Objet_Install:Méthodes:loadResources	/fr/docs/Archive/Mozilla/XPInstall/Référence_de_l_API_XPInstall/Objet_Install/Méthodes/loadResources
/fr/docs/Référence_de_l'API_XPInstall:Objet_Install:Méthodes:logComment	/fr/docs/Archive/Mozilla/XPInstall/Référence_de_l_API_XPInstall/Objet_Install/Méthodes/logComment
/fr/docs/Référence_de_l'API_XPInstall:Objet_Install:Méthodes:patch	/fr/docs/Archive/Mozilla/XPInstall/Référence_de_l_API_XPInstall/Objet_Install/Méthodes/patch
/fr/docs/Référence_de_l'API_XPInstall:Objet_Install:Méthodes:performInstall	/fr/docs/Archive/Mozilla/XPInstall/Référence_de_l_API_XPInstall/Objet_Install/Méthodes/performInstall
/fr/docs/Référence_de_l'API_XPInstall:Objet_Install:Méthodes:refreshPlugins	/fr/docs/Archive/Mozilla/XPInstall/Référence_de_l_API_XPInstall/Objet_Install/Méthodes/refreshPlugins
/fr/docs/Référence_de_l'API_XPInstall:Objet_Install:Méthodes:registerChrome	/fr/docs/Archive/Mozilla/XPInstall/Référence_de_l_API_XPInstall/Objet_Install/Méthodes/registerChrome
/fr/docs/Référence_de_l'API_XPInstall:Objet_Install:Méthodes:resetError	/fr/docs/Archive/Mozilla/XPInstall/Référence_de_l_API_XPInstall/Objet_Install/Méthodes/resetError
/fr/docs/Référence_de_l'API_XPInstall:Objet_Install:Méthodes:setPackageFolder	/fr/docs/Archive/Mozilla/XPInstall/Référence_de_l_API_XPInstall/Objet_Install/Méthodes/setPackageFolder
/fr/docs/Référence_de_l'API_XPInstall:Objet_Install:Propriétés	/fr/docs/Archive/Mozilla/XPInstall/Référence_de_l_API_XPInstall/Objet_Install/Propriétés
/fr/docs/Référence_de_l'API_XPInstall:Objet_InstallTrigger	/fr/docs/Archive/Mozilla/XPInstall/Référence_de_l_API_XPInstall/Objet_InstallTrigger
/fr/docs/Référence_de_l'API_XPInstall:Objet_InstallVersion	/fr/docs/Archive/Mozilla/XPInstall/Référence_de_l_API_XPInstall/Objet_InstallVersion
/fr/docs/Référence_de_l'API_XPInstall:Objet_InstallVersion:Méthodes	/fr/docs/Archive/Mozilla/XPInstall/Référence_de_l_API_XPInstall/Objet_InstallVersion/Méthodes
/fr/docs/Référence_de_l'API_XPInstall:Objet_InstallVersion:Méthodes:compareTo	/fr/docs/Archive/Mozilla/XPInstall/Référence_de_l_API_XPInstall/Objet_InstallVersion/Méthodes/compareTo
/fr/docs/Référence_de_l'API_XPInstall:Objet_InstallVersion:Méthodes:init	/fr/docs/Archive/Mozilla/XPInstall/Référence_de_l_API_XPInstall/Objet_InstallVersion/Méthodes/init
/fr/docs/Référence_de_l'API_XPInstall:Objet_InstallVersion:Méthodes:toString	/fr/docs/Archive/Mozilla/XPInstall/Référence_de_l_API_XPInstall/Objet_InstallVersion/Méthodes/toString
/fr/docs/Référence_de_l'API_XPInstall:Objet_InstallVersion:Propriétés	/fr/docs/Archive/Mozilla/XPInstall/Référence_de_l_API_XPInstall/Objet_InstallVersion/Propriétés
/fr/docs/Référence_de_l'API_XPInstall:Objet_WinProfile	/fr/docs/Archive/Mozilla/XPInstall/Référence_de_l_API_XPInstall/Objet_WinProfile
/fr/docs/Référence_de_l'API_XPInstall:Objet_WinProfile:Méthodes	/fr/docs/Archive/Mozilla/XPInstall/Référence_de_l_API_XPInstall/Objet_WinProfile/Méthodes
/fr/docs/Référence_de_l'API_XPInstall:Objet_WinProfile:Méthodes:getString	/fr/docs/Archive/Mozilla/XPInstall/Référence_de_l_API_XPInstall/Objet_WinProfile/Méthodes/getString
/fr/docs/Référence_de_l'API_XPInstall:Objet_WinProfile:Méthodes:writeString	/fr/docs/Archive/Mozilla/XPInstall/Référence_de_l_API_XPInstall/Objet_WinProfile/Méthodes/writeString
/fr/docs/Référence_de_l'API_XPInstall:Objet_WinReg	/fr/docs/Archive/Mozilla/XPInstall/Référence_de_l_API_XPInstall/Objet_WinReg
/fr/docs/Référence_de_l'API_XPInstall:Objet_WinReg:Méthodes	/fr/docs/Archive/Mozilla/XPInstall/Référence_de_l_API_XPInstall/Objet_WinReg/Méthodes
/fr/docs/Référence_de_l'API_XPInstall:Objet_WinReg:Méthodes:createKey	/fr/docs/Archive/Mozilla/XPInstall/Référence_de_l_API_XPInstall/Objet_WinReg/Méthodes/createKey
/fr/docs/Référence_de_l'API_XPInstall:Objet_WinReg:Méthodes:deleteKey	/fr/docs/Archive/Mozilla/XPInstall/Référence_de_l_API_XPInstall/Objet_WinReg/Méthodes/deleteKey
/fr/docs/Référence_de_l'API_XPInstall:Objet_WinReg:Méthodes:deleteValue	/fr/docs/Archive/Mozilla/XPInstall/Référence_de_l_API_XPInstall/Objet_WinReg/Méthodes/deleteValue
/fr/docs/Référence_de_l'API_XPInstall:Objet_WinReg:Méthodes:enumKeys	/fr/docs/Archive/Mozilla/XPInstall/Référence_de_l_API_XPInstall/Objet_WinReg/Méthodes/enumKeys
/fr/docs/Référence_de_l'API_XPInstall:Objet_WinReg:Méthodes:enumValueNames	/fr/docs/Archive/Mozilla/XPInstall/Référence_de_l_API_XPInstall/Objet_WinReg/Méthodes/enumValueNames
/fr/docs/Référence_de_l'API_XPInstall:Objet_WinReg:Méthodes:getValue	/fr/docs/Archive/Mozilla/XPInstall/Référence_de_l_API_XPInstall/Objet_WinReg/Méthodes/getValue
/fr/docs/Référence_de_l'API_XPInstall:Objet_WinReg:Méthodes:getValueNumber	/fr/docs/Archive/Mozilla/XPInstall/Référence_de_l_API_XPInstall/Objet_WinReg/Méthodes/getValueNumber
/fr/docs/Référence_de_l'API_XPInstall:Objet_WinReg:Méthodes:getValueString	/fr/docs/Archive/Mozilla/XPInstall/Référence_de_l_API_XPInstall/Objet_WinReg/Méthodes/getValueString
/fr/docs/Référence_de_l'API_XPInstall:Objet_WinReg:Méthodes:isKeyWritable	/fr/docs/Archive/Mozilla/XPInstall/Référence_de_l_API_XPInstall/Objet_WinReg/Méthodes/isKeyWritable
/fr/docs/Référence_de_l'API_XPInstall:Objet_WinReg:Méthodes:keyExists	/fr/docs/Archive/Mozilla/XPInstall/Référence_de_l_API_XPInstall/Objet_WinReg/Méthodes/keyExists
/fr/docs/Référence_de_l'API_XPInstall:Objet_WinReg:Méthodes:setRootKey	/fr/docs/Archive/Mozilla/XPInstall/Référence_de_l_API_XPInstall/Objet_WinReg/Méthodes/setRootKey
/fr/docs/Référence_de_l'API_XPInstall:Objet_WinReg:Méthodes:setValue	/fr/docs/Archive/Mozilla/XPInstall/Référence_de_l_API_XPInstall/Objet_WinReg/Méthodes/setValue
/fr/docs/Référence_de_l'API_XPInstall:Objet_WinReg:Méthodes:setValueNumber	/fr/docs/Archive/Mozilla/XPInstall/Référence_de_l_API_XPInstall/Objet_WinReg/Méthodes/setValueNumber
/fr/docs/Référence_de_l'API_XPInstall:Objet_WinReg:Méthodes:setValueString	/fr/docs/Archive/Mozilla/XPInstall/Référence_de_l_API_XPInstall/Objet_WinReg/Méthodes/setValueString
/fr/docs/Référence_de_l'API_XPInstall:Objet_WinReg:Méthodes:valueExists	/fr/docs/Archive/Mozilla/XPInstall/Référence_de_l_API_XPInstall/Objet_WinReg/Méthodes/valueExists
/fr/docs/Référence_de_l'API_XPInstall:Objet_WinReg:WinRegValue	/fr/docs/Archive/Mozilla/XPInstall/Référence_de_l_API_XPInstall/Objet_WinReg/WinRegValue
/fr/docs/Référence_de_l_API_XPInstall	/fr/docs/Archive/Mozilla/XPInstall/Référence_de_l_API_XPInstall
/fr/docs/Référence_de_l_API_XPInstall/Codes_retournés	/fr/docs/Archive/Mozilla/XPInstall/Référence_de_l_API_XPInstall/Codes_retournés
/fr/docs/Référence_de_l_API_XPInstall/Exemples	/fr/docs/Archive/Mozilla/XPInstall/Référence_de_l_API_XPInstall/Exemples
/fr/docs/Référence_de_l_API_XPInstall/Exemples/File.macAlias	/fr/docs/Archive/Mozilla/XPInstall/Référence_de_l_API_XPInstall/Exemples/File.macAlias
/fr/docs/Référence_de_l_API_XPInstall/Exemples/File.windowsShortcut	/fr/docs/Archive/Mozilla/XPInstall/Référence_de_l_API_XPInstall/Exemples/File.windowsShortcut
/fr/docs/Référence_de_l_API_XPInstall/Exemples/Install.addDirectory	/fr/docs/Archive/Mozilla/XPInstall/Référence_de_l_API_XPInstall/Exemples/Install.addDirectory
/fr/docs/Référence_de_l_API_XPInstall/Exemples/Install.addFile	/fr/docs/Archive/Mozilla/XPInstall/Référence_de_l_API_XPInstall/Exemples/Install.addFile
/fr/docs/Référence_de_l_API_XPInstall/Exemples/InstallTrigger.installChrome	/fr/docs/Archive/Mozilla/XPInstall/Référence_de_l_API_XPInstall/Exemples/InstallTrigger.installChrome
/fr/docs/Référence_de_l_API_XPInstall/Exemples/InstallTrigger.startSoftwareUpdate	/fr/docs/Archive/Mozilla/XPInstall/Référence_de_l_API_XPInstall/Exemples/InstallTrigger.startSoftwareUpdate
/fr/docs/Référence_de_l_API_XPInstall/Exemples/Scripts_de_déclenchement_et_scripts_d'installation	/fr/docs/Archive/Mozilla/XPInstall/Référence_de_l_API_XPInstall/Exemples/Scripts_de_déclenchement_et_scripts_d'installation
/fr/docs/Référence_de_l_API_XPInstall/Exemples/Windows_Install	/fr/docs/Archive/Mozilla/XPInstall/Référence_de_l_API_XPInstall/Exemples/Windows_Install
/fr/docs/Référence_de_l_API_XPInstall/Objet_File	/fr/docs/Archive/Mozilla/XPInstall/Référence_de_l_API_XPInstall/Objet_File
/fr/docs/Référence_de_l_API_XPInstall/Objet_File/Méthodes	/fr/docs/Archive/Mozilla/XPInstall/Référence_de_l_API_XPInstall/Objet_File/Méthodes
/fr/docs/Référence_de_l_API_XPInstall/Objet_File/Méthodes/copy	/fr/docs/Archive/Mozilla/XPInstall/Référence_de_l_API_XPInstall/Objet_File/Méthodes/copy
/fr/docs/Référence_de_l_API_XPInstall/Objet_File/Méthodes/dirCreate	/fr/docs/Archive/Mozilla/XPInstall/Référence_de_l_API_XPInstall/Objet_File/Méthodes/dirCreate
/fr/docs/Référence_de_l_API_XPInstall/Objet_File/Méthodes/dirGetParent	/fr/docs/Archive/Mozilla/XPInstall/Référence_de_l_API_XPInstall/Objet_File/Méthodes/dirGetParent
/fr/docs/Référence_de_l_API_XPInstall/Objet_File/Méthodes/dirRemove	/fr/docs/Archive/Mozilla/XPInstall/Référence_de_l_API_XPInstall/Objet_File/Méthodes/dirRemove
/fr/docs/Référence_de_l_API_XPInstall/Objet_File/Méthodes/dirRename	/fr/docs/Archive/Mozilla/XPInstall/Référence_de_l_API_XPInstall/Objet_File/Méthodes/dirRename
/fr/docs/Référence_de_l_API_XPInstall/Objet_File/Méthodes/diskSpaceAvailable	/fr/docs/Archive/Mozilla/XPInstall/Référence_de_l_API_XPInstall/Objet_File/Méthodes/diskSpaceAvailable
/fr/docs/Référence_de_l_API_XPInstall/Objet_File/Méthodes/execute	/fr/docs/Archive/Mozilla/XPInstall/Référence_de_l_API_XPInstall/Objet_File/Méthodes/execute
/fr/docs/Référence_de_l_API_XPInstall/Objet_File/Méthodes/exists	/fr/docs/Archive/Mozilla/XPInstall/Référence_de_l_API_XPInstall/Objet_File/Méthodes/exists
/fr/docs/Référence_de_l_API_XPInstall/Objet_File/Méthodes/isDirectory	/fr/docs/Archive/Mozilla/XPInstall/Référence_de_l_API_XPInstall/Objet_File/Méthodes/isDirectory
/fr/docs/Référence_de_l_API_XPInstall/Objet_File/Méthodes/isFile	/fr/docs/Archive/Mozilla/XPInstall/Référence_de_l_API_XPInstall/Objet_File/Méthodes/isFile
/fr/docs/Référence_de_l_API_XPInstall/Objet_File/Méthodes/macAlias	/fr/docs/Archive/Mozilla/XPInstall/Référence_de_l_API_XPInstall/Objet_File/Méthodes/macAlias
/fr/docs/Référence_de_l_API_XPInstall/Objet_File/Méthodes/modDate	/fr/docs/Archive/Mozilla/XPInstall/Référence_de_l_API_XPInstall/Objet_File/Méthodes/modDate
/fr/docs/Référence_de_l_API_XPInstall/Objet_File/Méthodes/modDateChanged	/fr/docs/Archive/Mozilla/XPInstall/Référence_de_l_API_XPInstall/Objet_File/Méthodes/modDateChanged
/fr/docs/Référence_de_l_API_XPInstall/Objet_File/Méthodes/move	/fr/docs/Archive/Mozilla/XPInstall/Référence_de_l_API_XPInstall/Objet_File/Méthodes/move
/fr/docs/Référence_de_l_API_XPInstall/Objet_File/Méthodes/remove	/fr/docs/Archive/Mozilla/XPInstall/Référence_de_l_API_XPInstall/Objet_File/Méthodes/remove
/fr/docs/Référence_de_l_API_XPInstall/Objet_File/Méthodes/rename	/fr/docs/Archive/Mozilla/XPInstall/Référence_de_l_API_XPInstall/Objet_File/Méthodes/rename
/fr/docs/Référence_de_l_API_XPInstall/Objet_File/Méthodes/size	/fr/docs/Archive/Mozilla/XPInstall/Référence_de_l_API_XPInstall/Objet_File/Méthodes/size
/fr/docs/Référence_de_l_API_XPInstall/Objet_File/Méthodes/windowsGetShortName	/fr/docs/Archive/Mozilla/XPInstall/Référence_de_l_API_XPInstall/Objet_File/Méthodes/windowsGetShortName
/fr/docs/Référence_de_l_API_XPInstall/Objet_File/Méthodes/windowsRegisterServer	/fr/docs/Archive/Mozilla/XPInstall/Référence_de_l_API_XPInstall/Objet_File/Méthodes/windowsRegisterServer
/fr/docs/Référence_de_l_API_XPInstall/Objet_File/Méthodes/windowsShortcut	/fr/docs/Archive/Mozilla/XPInstall/Référence_de_l_API_XPInstall/Objet_File/Méthodes/windowsShortcut
/fr/docs/Référence_de_l_API_XPInstall/Objet_Install	/fr/docs/Archive/Mozilla/XPInstall/Référence_de_l_API_XPInstall/Objet_Install
/fr/docs/Référence_de_l_API_XPInstall/Objet_Install/Méthodes	/fr/docs/Archive/Mozilla/XPInstall/Référence_de_l_API_XPInstall/Objet_Install/Méthodes
/fr/docs/Référence_de_l_API_XPInstall/Objet_Install/Méthodes/addDirectory	/fr/docs/Archive/Mozilla/XPInstall/Référence_de_l_API_XPInstall/Objet_Install/Méthodes/addDirectory
/fr/docs/Référence_de_l_API_XPInstall/Objet_Install/Méthodes/addFile	/fr/docs/Archive/Mozilla/XPInstall/Référence_de_l_API_XPInstall/Objet_Install/Méthodes/addFile
/fr/docs/Référence_de_l_API_XPInstall/Objet_Install/Méthodes/alert	/fr/docs/Archive/Mozilla/XPInstall/Référence_de_l_API_XPInstall/Objet_Install/Méthodes/alert
/fr/docs/Référence_de_l_API_XPInstall/Objet_Install/Méthodes/cancelInstall	/fr/docs/Archive/Mozilla/XPInstall/Référence_de_l_API_XPInstall/Objet_Install/Méthodes/cancelInstall
/fr/docs/Référence_de_l_API_XPInstall/Objet_Install/Méthodes/confirm	/fr/docs/Archive/Mozilla/XPInstall/Référence_de_l_API_XPInstall/Objet_Install/Méthodes/confirm
/fr/docs/Référence_de_l_API_XPInstall/Objet_Install/Méthodes/deleteRegisteredFile	/fr/docs/Archive/Mozilla/XPInstall/Référence_de_l_API_XPInstall/Objet_Install/Méthodes/deleteRegisteredFile
/fr/docs/Référence_de_l_API_XPInstall/Objet_Install/Méthodes/execute	/fr/docs/Archive/Mozilla/XPInstall/Référence_de_l_API_XPInstall/Objet_Install/Méthodes/execute
/fr/docs/Référence_de_l_API_XPInstall/Objet_Install/Méthodes/gestalt	/fr/docs/Archive/Mozilla/XPInstall/Référence_de_l_API_XPInstall/Objet_Install/Méthodes/gestalt
/fr/docs/Référence_de_l_API_XPInstall/Objet_Install/Méthodes/getComponentFolder	/fr/docs/Archive/Mozilla/XPInstall/Référence_de_l_API_XPInstall/Objet_Install/Méthodes/getComponentFolder
/fr/docs/Référence_de_l_API_XPInstall/Objet_Install/Méthodes/getFolder	/fr/docs/Archive/Mozilla/XPInstall/Référence_de_l_API_XPInstall/Objet_Install/Méthodes/getFolder
/fr/docs/Référence_de_l_API_XPInstall/Objet_Install/Méthodes/getLastError	/fr/docs/Archive/Mozilla/XPInstall/Référence_de_l_API_XPInstall/Objet_Install/Méthodes/getLastError
/fr/docs/Référence_de_l_API_XPInstall/Objet_Install/Méthodes/getWinProfile	/fr/docs/Archive/Mozilla/XPInstall/Référence_de_l_API_XPInstall/Objet_Install/Méthodes/getWinProfile
/fr/docs/Référence_de_l_API_XPInstall/Objet_Install/Méthodes/getWinRegistry	/fr/docs/Archive/Mozilla/XPInstall/Référence_de_l_API_XPInstall/Objet_Install/Méthodes/getWinRegistry
/fr/docs/Référence_de_l_API_XPInstall/Objet_Install/Méthodes/initInstall	/fr/docs/Archive/Mozilla/XPInstall/Référence_de_l_API_XPInstall/Objet_Install/Méthodes/initInstall
/fr/docs/Référence_de_l_API_XPInstall/Objet_Install/Méthodes/loadResources	/fr/docs/Archive/Mozilla/XPInstall/Référence_de_l_API_XPInstall/Objet_Install/Méthodes/loadResources
/fr/docs/Référence_de_l_API_XPInstall/Objet_Install/Méthodes/logComment	/fr/docs/Archive/Mozilla/XPInstall/Référence_de_l_API_XPInstall/Objet_Install/Méthodes/logComment
/fr/docs/Référence_de_l_API_XPInstall/Objet_Install/Méthodes/patch	/fr/docs/Archive/Mozilla/XPInstall/Référence_de_l_API_XPInstall/Objet_Install/Méthodes/patch
/fr/docs/Référence_de_l_API_XPInstall/Objet_Install/Méthodes/performInstall	/fr/docs/Archive/Mozilla/XPInstall/Référence_de_l_API_XPInstall/Objet_Install/Méthodes/performInstall
/fr/docs/Référence_de_l_API_XPInstall/Objet_Install/Méthodes/refreshPlugins	/fr/docs/Archive/Mozilla/XPInstall/Référence_de_l_API_XPInstall/Objet_Install/Méthodes/refreshPlugins
/fr/docs/Référence_de_l_API_XPInstall/Objet_Install/Méthodes/registerChrome	/fr/docs/Archive/Mozilla/XPInstall/Référence_de_l_API_XPInstall/Objet_Install/Méthodes/registerChrome
/fr/docs/Référence_de_l_API_XPInstall/Objet_Install/Méthodes/resetError	/fr/docs/Archive/Mozilla/XPInstall/Référence_de_l_API_XPInstall/Objet_Install/Méthodes/resetError
/fr/docs/Référence_de_l_API_XPInstall/Objet_Install/Méthodes/setPackageFolder	/fr/docs/Archive/Mozilla/XPInstall/Référence_de_l_API_XPInstall/Objet_Install/Méthodes/setPackageFolder
/fr/docs/Référence_de_l_API_XPInstall/Objet_Install/Propriétés	/fr/docs/Archive/Mozilla/XPInstall/Référence_de_l_API_XPInstall/Objet_Install/Propriétés
/fr/docs/Référence_de_l_API_XPInstall/Objet_InstallTrigger	/fr/docs/Archive/Mozilla/XPInstall/Référence_de_l_API_XPInstall/Objet_InstallTrigger
/fr/docs/Référence_de_l_API_XPInstall/Objet_InstallVersion	/fr/docs/Archive/Mozilla/XPInstall/Référence_de_l_API_XPInstall/Objet_InstallVersion
/fr/docs/Référence_de_l_API_XPInstall/Objet_InstallVersion/Méthodes	/fr/docs/Archive/Mozilla/XPInstall/Référence_de_l_API_XPInstall/Objet_InstallVersion/Méthodes
/fr/docs/Référence_de_l_API_XPInstall/Objet_InstallVersion/Méthodes/compareTo	/fr/docs/Archive/Mozilla/XPInstall/Référence_de_l_API_XPInstall/Objet_InstallVersion/Méthodes/compareTo
/fr/docs/Référence_de_l_API_XPInstall/Objet_InstallVersion/Méthodes/init	/fr/docs/Archive/Mozilla/XPInstall/Référence_de_l_API_XPInstall/Objet_InstallVersion/Méthodes/init
/fr/docs/Référence_de_l_API_XPInstall/Objet_InstallVersion/Méthodes/toString	/fr/docs/Archive/Mozilla/XPInstall/Référence_de_l_API_XPInstall/Objet_InstallVersion/Méthodes/toString
/fr/docs/Référence_de_l_API_XPInstall/Objet_InstallVersion/Propriétés	/fr/docs/Archive/Mozilla/XPInstall/Référence_de_l_API_XPInstall/Objet_InstallVersion/Propriétés
/fr/docs/Référence_de_l_API_XPInstall/Objet_WinProfile	/fr/docs/Archive/Mozilla/XPInstall/Référence_de_l_API_XPInstall/Objet_WinProfile
/fr/docs/Référence_de_l_API_XPInstall/Objet_WinProfile/Méthodes	/fr/docs/Archive/Mozilla/XPInstall/Référence_de_l_API_XPInstall/Objet_WinProfile/Méthodes
/fr/docs/Référence_de_l_API_XPInstall/Objet_WinProfile/Méthodes/getString	/fr/docs/Archive/Mozilla/XPInstall/Référence_de_l_API_XPInstall/Objet_WinProfile/Méthodes/getString
/fr/docs/Référence_de_l_API_XPInstall/Objet_WinProfile/Méthodes/writeString	/fr/docs/Archive/Mozilla/XPInstall/Référence_de_l_API_XPInstall/Objet_WinProfile/Méthodes/writeString
/fr/docs/Référence_de_l_API_XPInstall/Objet_WinReg	/fr/docs/Archive/Mozilla/XPInstall/Référence_de_l_API_XPInstall/Objet_WinReg
/fr/docs/Référence_de_l_API_XPInstall/Objet_WinReg/Méthodes	/fr/docs/Archive/Mozilla/XPInstall/Référence_de_l_API_XPInstall/Objet_WinReg/Méthodes
/fr/docs/Référence_de_l_API_XPInstall/Objet_WinReg/Méthodes/createKey	/fr/docs/Archive/Mozilla/XPInstall/Référence_de_l_API_XPInstall/Objet_WinReg/Méthodes/createKey
/fr/docs/Référence_de_l_API_XPInstall/Objet_WinReg/Méthodes/deleteKey	/fr/docs/Archive/Mozilla/XPInstall/Référence_de_l_API_XPInstall/Objet_WinReg/Méthodes/deleteKey
/fr/docs/Référence_de_l_API_XPInstall/Objet_WinReg/Méthodes/deleteValue	/fr/docs/Archive/Mozilla/XPInstall/Référence_de_l_API_XPInstall/Objet_WinReg/Méthodes/deleteValue
/fr/docs/Référence_de_l_API_XPInstall/Objet_WinReg/Méthodes/enumKeys	/fr/docs/Archive/Mozilla/XPInstall/Référence_de_l_API_XPInstall/Objet_WinReg/Méthodes/enumKeys
/fr/docs/Référence_de_l_API_XPInstall/Objet_WinReg/Méthodes/enumValueNames	/fr/docs/Archive/Mozilla/XPInstall/Référence_de_l_API_XPInstall/Objet_WinReg/Méthodes/enumValueNames
/fr/docs/Référence_de_l_API_XPInstall/Objet_WinReg/Méthodes/getValue	/fr/docs/Archive/Mozilla/XPInstall/Référence_de_l_API_XPInstall/Objet_WinReg/Méthodes/getValue
/fr/docs/Référence_de_l_API_XPInstall/Objet_WinReg/Méthodes/getValueNumber	/fr/docs/Archive/Mozilla/XPInstall/Référence_de_l_API_XPInstall/Objet_WinReg/Méthodes/getValueNumber
/fr/docs/Référence_de_l_API_XPInstall/Objet_WinReg/Méthodes/getValueString	/fr/docs/Archive/Mozilla/XPInstall/Référence_de_l_API_XPInstall/Objet_WinReg/Méthodes/getValueString
/fr/docs/Référence_de_l_API_XPInstall/Objet_WinReg/Méthodes/isKeyWritable	/fr/docs/Archive/Mozilla/XPInstall/Référence_de_l_API_XPInstall/Objet_WinReg/Méthodes/isKeyWritable
/fr/docs/Référence_de_l_API_XPInstall/Objet_WinReg/Méthodes/keyExists	/fr/docs/Archive/Mozilla/XPInstall/Référence_de_l_API_XPInstall/Objet_WinReg/Méthodes/keyExists
/fr/docs/Référence_de_l_API_XPInstall/Objet_WinReg/Méthodes/setRootKey	/fr/docs/Archive/Mozilla/XPInstall/Référence_de_l_API_XPInstall/Objet_WinReg/Méthodes/setRootKey
/fr/docs/Référence_de_l_API_XPInstall/Objet_WinReg/Méthodes/setValue	/fr/docs/Archive/Mozilla/XPInstall/Référence_de_l_API_XPInstall/Objet_WinReg/Méthodes/setValue
/fr/docs/Référence_de_l_API_XPInstall/Objet_WinReg/Méthodes/setValueNumber	/fr/docs/Archive/Mozilla/XPInstall/Référence_de_l_API_XPInstall/Objet_WinReg/Méthodes/setValueNumber
/fr/docs/Référence_de_l_API_XPInstall/Objet_WinReg/Méthodes/setValueString	/fr/docs/Archive/Mozilla/XPInstall/Référence_de_l_API_XPInstall/Objet_WinReg/Méthodes/setValueString
/fr/docs/Référence_de_l_API_XPInstall/Objet_WinReg/Méthodes/valueExists	/fr/docs/Archive/Mozilla/XPInstall/Référence_de_l_API_XPInstall/Objet_WinReg/Méthodes/valueExists
/fr/docs/Référence_de_l_API_XPInstall/Objet_WinReg/WinRegValue	/fr/docs/Archive/Mozilla/XPInstall/Référence_de_l_API_XPInstall/Objet_WinReg/WinRegValue
/fr/docs/SDK_Gecko	/fr/docs/Mozilla/Gecko/SDK_Gecko
/fr/docs/SOAP_dans_les_navigateurs_Gecko	/fr/docs/Archive/Mozilla/Firefox/SOAP_dans_les_navigateurs_Gecko
/fr/docs/Signer_un_XPI	/fr/docs/Mozilla/Add-ons/Distribution
/fr/docs/Standards_du_Web	/fr/docs/Archive/Standards_du_Web
/fr/docs/Standards_du_Web/Communauté	/fr/docs/Archive/Standards_du_Web/Communauté
/fr/docs/Standards_du_Web:Communauté	/fr/docs/Archive/Standards_du_Web/Communauté
/fr/docs/Tinderbox	/fr/docs/Archive/Mozilla/Tinderbox
/fr/docs/Travailler_avec_des_fenêtres_dans_le_chrome	/fr/docs/Mozilla/Working_with_windows_in_chrome_code
/fr/docs/Tutoriel_XUL	/fr/docs/Archive/Mozilla/XUL/Tutoriel_XUL
/fr/docs/Tutoriel_XUL/Ajout_d'éléments_HTML	/fr/docs/Archive/Mozilla/XUL/Tutoriel_XUL/Ajout_d'éléments_HTML
/fr/docs/Tutoriel_XUL/Ajout_de_gestionnaire_d'évènements	/fr/docs/Archive/Mozilla/XUL/Tutoriel_XUL/Ajout_de_gestionnaire_d_évènements
/fr/docs/Tutoriel_XUL/Ajout_de_gestionnaire_d_évènements	/fr/docs/Archive/Mozilla/XUL/Tutoriel_XUL/Ajout_de_gestionnaire_d_évènements
/fr/docs/Tutoriel_XUL/Ajout_de_gestionnaires_d'évènements	/fr/docs/Archive/Mozilla/XUL/Tutoriel_XUL/Ajout_de_gestionnaires_d'évènements
/fr/docs/Tutoriel_XUL/Ajout_de_méthodes	/fr/docs/Archive/Mozilla/XUL/Tutoriel_XUL/Ajout_de_méthodes
/fr/docs/Tutoriel_XUL/Ajout_de_propriétés	/fr/docs/Archive/Mozilla/XUL/Tutoriel_XUL/Ajout_de_propriétés
/fr/docs/Tutoriel_XUL/Ajouter_des_boutons	/fr/docs/Archive/Mozilla/XUL/Tutoriel_XUL/Ajouter_des_boutons
/fr/docs/Tutoriel_XUL/Ajouter_des_feuilles_de_style	/fr/docs/Archive/Mozilla/XUL/Tutoriel_XUL/Ajouter_des_feuilles_de_style
/fr/docs/Tutoriel_XUL/Ajouter_des_libellés_et_des_images	/fr/docs/Archive/Mozilla/XUL/Tutoriel_XUL/Ajouter_des_libellés_et_des_images
/fr/docs/Tutoriel_XUL/Ajouter_plus_d'éléments	/fr/docs/Archive/Mozilla/XUL/Tutoriel_XUL/Ajouter_plus_d'éléments
/fr/docs/Tutoriel_XUL/Arbres	/fr/docs/Archive/Mozilla/XUL/Tutoriel_XUL/Arbres
/fr/docs/Tutoriel_XUL/Arbres_et_Gabarits	/fr/docs/Archive/Mozilla/XUL/Tutoriel_XUL/Arbres_et_Gabarits
/fr/docs/Tutoriel_XUL/Assistant_avançé	/fr/docs/Archive/Mozilla/XUL/Tutoriel_XUL/Assistant_avançé
/fr/docs/Tutoriel_XUL/Autres_caractéristiques_des_arbres	/fr/docs/Archive/Mozilla/XUL/Tutoriel_XUL/Autres_caractéristiques_des_arbres
/fr/docs/Tutoriel_XUL/Barres_de_défilement	/fr/docs/Archive/Mozilla/XUL/Tutoriel_XUL/Barres_de_défilement
/fr/docs/Tutoriel_XUL/Barres_de_menus_simples	/fr/docs/Archive/Mozilla/XUL/Tutoriel_XUL/Barres_de_menus_simples
/fr/docs/Tutoriel_XUL/Boîte_de_dialogue_de_fichier	/fr/docs/Archive/Mozilla/XUL/Tutoriel_XUL/Boîte_de_dialogue_de_fichier
/fr/docs/Tutoriel_XUL/Broadcasters_et_Observateurs	/fr/docs/Archive/Mozilla/XUL/Tutoriel_XUL/Broadcasters_et_Observateurs
/fr/docs/Tutoriel_XUL/Cadres_de_contenu	/fr/docs/Archive/Mozilla/XUL/Tutoriel_XUL/Cadres_de_contenu
/fr/docs/Tutoriel_XUL/Caractéristiques_d'une_fenêtre	/fr/docs/Archive/Mozilla/XUL/Tutoriel_XUL/Caractéristiques_d'une_fenêtre
/fr/docs/Tutoriel_XUL/Commandes	/fr/docs/Archive/Mozilla/XUL/Tutoriel_XUL/Commandes
/fr/docs/Tutoriel_XUL/Contenu_anonyme	/fr/docs/Archive/Mozilla/XUL/Tutoriel_XUL/Contenu_anonyme
/fr/docs/Tutoriel_XUL/Création_d'un_assistant	/fr/docs/Archive/Mozilla/XUL/Tutoriel_XUL/Création_d'un_assistant
/fr/docs/Tutoriel_XUL/Création_d'un_programme_d'installation	/fr/docs/Archive/Mozilla/XUL/Tutoriel_XUL/Création_d'un_programme_d'installation
/fr/docs/Tutoriel_XUL/Créer_des_boîtes_de_dialogue	/fr/docs/Archive/Mozilla/XUL/Tutoriel_XUL/Créer_des_boîtes_de_dialogue
/fr/docs/Tutoriel_XUL/Créer_un_thème	/fr/docs/Archive/Mozilla/XUL/Tutoriel_XUL/Créer_un_thème
/fr/docs/Tutoriel_XUL/Créer_une_fenêtre	/fr/docs/Archive/Mozilla/XUL/Tutoriel_XUL/Créer_une_fenêtre
/fr/docs/Tutoriel_XUL/Document_Object_Model	/fr/docs/Archive/Mozilla/XUL/Tutoriel_XUL/Document_Object_Model
/fr/docs/Tutoriel_XUL/Données_persistantes	/fr/docs/Archive/Mozilla/XUL/Tutoriel_XUL/Données_persistantes
/fr/docs/Tutoriel_XUL/Détails_sur_le_modèle_de_boîte	/fr/docs/Archive/Mozilla/XUL/Tutoriel_XUL/Détails_sur_le_modèle_de_boîte
/fr/docs/Tutoriel_XUL/Détails_sur_les_vues_d'arbres	/fr/docs/Archive/Mozilla/XUL/Tutoriel_XUL/Détails_sur_les_vues_d'arbres
/fr/docs/Tutoriel_XUL/Exemple_XBL	/fr/docs/Archive/Mozilla/XUL/Tutoriel_XUL/Exemple_XBL
/fr/docs/Tutoriel_XUL/Exemples_XPCOM	/fr/docs/Archive/Mozilla/XUL/Tutoriel_XUL/Exemples_XPCOM
/fr/docs/Tutoriel_XUL/Focus_et_Selection	/fr/docs/Archive/Mozilla/XUL/Tutoriel_XUL/Focus_et_Selection
/fr/docs/Tutoriel_XUL/Fonctions_additionnelles_d'installation	/fr/docs/Archive/Mozilla/XUL/Tutoriel_XUL/Fonctions_additionnelles_d'installation
/fr/docs/Tutoriel_XUL/Gabarits	/fr/docs/Archive/Mozilla/XUL/Tutoriel_XUL/Gabarits
/fr/docs/Tutoriel_XUL/Grilles	/fr/docs/Archive/Mozilla/XUL/Tutoriel_XUL/Grilles
/fr/docs/Tutoriel_XUL/Héritage_XBL	/fr/docs/Archive/Mozilla/XUL/Tutoriel_XUL/Héritage_XBL
/fr/docs/Tutoriel_XUL/Héritage_d'attributs_XBL	/fr/docs/Archive/Mozilla/XUL/Tutoriel_XUL/Héritage_d'attributs_XBL
/fr/docs/Tutoriel_XUL/Indicateurs_de_progression	/fr/docs/Archive/Mozilla/XUL/Tutoriel_XUL/Indicateurs_de_progression
/fr/docs/Tutoriel_XUL/Interfaces_XPCOM	/fr/docs/Archive/Mozilla/XUL/Tutoriel_XUL/Interfaces_XPCOM
/fr/docs/Tutoriel_XUL/Introduction	/fr/docs/Archive/Mozilla/XUL/Tutoriel_XUL/Introduction
/fr/docs/Tutoriel_XUL/Introduction_à_RDF	/fr/docs/Archive/Mozilla/XUL/Tutoriel_XUL/Introduction_à_RDF
/fr/docs/Tutoriel_XUL/Introduction_à_XBL	/fr/docs/Archive/Mozilla/XUL/Tutoriel_XUL/Introduction_à_XBL
/fr/docs/Tutoriel_XUL/L'URL_Chrome	/fr/docs/Archive/Mozilla/XUL/Tutoriel_XUL/L'URL_Chrome
/fr/docs/Tutoriel_XUL/La_structure_XUL	/fr/docs/Archive/Mozilla/XUL/Tutoriel_XUL/La_structure_XUL
/fr/docs/Tutoriel_XUL/Le_modèle_de_boîte	/fr/docs/Archive/Mozilla/XUL/Tutoriel_XUL/Le_modèle_de_boîte
/fr/docs/Tutoriel_XUL/Les_boîtes_de_groupe	/fr/docs/Archive/Mozilla/XUL/Tutoriel_XUL/Les_boîtes_de_groupe
/fr/docs/Tutoriel_XUL/Les_champs_de_saisie	/fr/docs/Archive/Mozilla/XUL/Tutoriel_XUL/Les_champs_de_saisie
/fr/docs/Tutoriel_XUL/Les_contrôles_de_listes	/fr/docs/Archive/Mozilla/XUL/Tutoriel_XUL/Les_contrôles_de_listes
/fr/docs/Tutoriel_XUL/Les_contrôles_numériques	/fr/docs/Archive/Mozilla/XUL/Tutoriel_XUL/Les_contrôles_numériques
/fr/docs/Tutoriel_XUL/Les_fichiers_de_propriétés	/fr/docs/Archive/Mozilla/XUL/Tutoriel_XUL/Les_fichiers_de_propriétés
/fr/docs/Tutoriel_XUL/Les_fichiers_manifest	/fr/docs/Archive/Mozilla/XUL/Tutoriel_XUL/Les_fichiers_manifest
/fr/docs/Tutoriel_XUL/Les_objets_boîtes	/fr/docs/Archive/Mozilla/XUL/Tutoriel_XUL/Les_objets_boîtes
/fr/docs/Tutoriel_XUL/Les_objets_boîtes_des_arbres	/fr/docs/Archive/Mozilla/XUL/Tutoriel_XUL/Les_objets_boîtes_des_arbres
/fr/docs/Tutoriel_XUL/Les_scripts_d'installation	/fr/docs/Archive/Mozilla/XUL/Tutoriel_XUL/Les_scripts_d'installation
/fr/docs/Tutoriel_XUL/Localisation	/fr/docs/Archive/Mozilla/XUL/Tutoriel_XUL/Localisation
/fr/docs/Tutoriel_XUL/Manipulation_de_listes	/fr/docs/Archive/Mozilla/XUL/Tutoriel_XUL/Manipulation_de_listes
/fr/docs/Tutoriel_XUL/Menus_défilants	/fr/docs/Archive/Mozilla/XUL/Tutoriel_XUL/Menus_défilants
/fr/docs/Tutoriel_XUL/Menus_surgissants	/fr/docs/Archive/Mozilla/XUL/Tutoriel_XUL/Menus_surgissants
/fr/docs/Tutoriel_XUL/Mise_à_jour_de_commandes	/fr/docs/Archive/Mozilla/XUL/Tutoriel_XUL/Mise_à_jour_de_commandes
/fr/docs/Tutoriel_XUL/Modification_d'une_interface_XUL	/fr/docs/Archive/Mozilla/XUL/Tutoriel_XUL/Modification_d'une_interface_XUL
/fr/docs/Tutoriel_XUL/Modification_du_thème_par_défaut	/fr/docs/Archive/Mozilla/XUL/Tutoriel_XUL/Modification_du_thème_par_défaut
/fr/docs/Tutoriel_XUL/Onglets	/fr/docs/Archive/Mozilla/XUL/Tutoriel_XUL/Onglets
/fr/docs/Tutoriel_XUL/Overlays	/fr/docs/Mozilla/Tech/XUL/Tutoriel_XUL/Overlays
/fr/docs/Tutoriel_XUL/Overlays_inter-paquetage	/fr/docs/Archive/Mozilla/XUL/Tutoriel_XUL/Overlays_inter-paquetage
/fr/docs/Tutoriel_XUL/Piles_et_Paquets	/fr/docs/Archive/Mozilla/XUL/Tutoriel_XUL/Piles_et_Paquets
/fr/docs/Tutoriel_XUL/Plus_de_caractéristiques_sur_les_boutons	/fr/docs/Archive/Mozilla/XUL/Tutoriel_XUL/Plus_de_caractéristiques_sur_les_boutons
/fr/docs/Tutoriel_XUL/Plus_de_fonctionnalités_de_menu	/fr/docs/Archive/Mozilla/XUL/Tutoriel_XUL/Plus_de_fonctionnalités_de_menu
/fr/docs/Tutoriel_XUL/Plus_sur_les_gestionnaires_d'évènements	/fr/docs/Archive/Mozilla/XUL/Tutoriel_XUL/Plus_sur_les_gestionnaires_d'évènements
/fr/docs/Tutoriel_XUL/Positionnement_dans_une_pile	/fr/docs/Archive/Mozilla/XUL/Tutoriel_XUL/Positionnement_dans_une_pile
/fr/docs/Tutoriel_XUL/Positionnement_des_éléments	/fr/docs/Archive/Mozilla/XUL/Tutoriel_XUL/Positionnement_des_éléments
/fr/docs/Tutoriel_XUL/Raccourcis_clavier	/fr/docs/Archive/Mozilla/XUL/Tutoriel_XUL/Raccourcis_clavier
/fr/docs/Tutoriel_XUL/Règles_avançées	/fr/docs/Archive/Mozilla/XUL/Tutoriel_XUL/Règles_avançées
/fr/docs/Tutoriel_XUL/Sources_de_données_RDF	/fr/docs/Archive/Mozilla/XUL/Tutoriel_XUL/Sources_de_données_RDF
/fr/docs/Tutoriel_XUL/Styler_un_arbre	/fr/docs/Archive/Mozilla/XUL/Tutoriel_XUL/Styler_un_arbre
/fr/docs/Tutoriel_XUL/Sélection_dans_les_arbres	/fr/docs/Archive/Mozilla/XUL/Tutoriel_XUL/Sélection_dans_les_arbres
/fr/docs/Tutoriel_XUL/Séparateurs	/fr/docs/Archive/Mozilla/XUL/Tutoriel_XUL/Séparateurs
/fr/docs/Tutoriel_XUL/Utilisation_des_spacers	/fr/docs/Archive/Mozilla/XUL/Tutoriel_XUL/Utilisation_des_spacers
/fr/docs/Tutoriel_XUL/Vues_d'arbre_personnalisées	/fr/docs/Archive/Mozilla/XUL/Tutoriel_XUL/Vues_d'arbre_personnalisées
/fr/docs/Tutoriel_XUL:Ajout_d'éléments_HTML	/fr/docs/Archive/Mozilla/XUL/Tutoriel_XUL/Ajout_d'éléments_HTML
/fr/docs/Tutoriel_XUL:Ajout_de_gestionnaire_d'évènements	/fr/docs/Archive/Mozilla/XUL/Tutoriel_XUL/Ajout_de_gestionnaire_d_évènements
/fr/docs/Tutoriel_XUL:Ajout_de_gestionnaires_d'évènements	/fr/docs/Archive/Mozilla/XUL/Tutoriel_XUL/Ajout_de_gestionnaires_d'évènements
/fr/docs/Tutoriel_XUL:Ajout_de_méthodes	/fr/docs/Archive/Mozilla/XUL/Tutoriel_XUL/Ajout_de_méthodes
/fr/docs/Tutoriel_XUL:Ajout_de_propriétés	/fr/docs/Archive/Mozilla/XUL/Tutoriel_XUL/Ajout_de_propriétés
/fr/docs/Tutoriel_XUL:Ajouter_des_boutons	/fr/docs/Archive/Mozilla/XUL/Tutoriel_XUL/Ajouter_des_boutons
/fr/docs/Tutoriel_XUL:Ajouter_des_feuilles_de_style	/fr/docs/Archive/Mozilla/XUL/Tutoriel_XUL/Ajouter_des_feuilles_de_style
/fr/docs/Tutoriel_XUL:Ajouter_des_libellés_et_des_images	/fr/docs/Archive/Mozilla/XUL/Tutoriel_XUL/Ajouter_des_libellés_et_des_images
/fr/docs/Tutoriel_XUL:Ajouter_plus_d'éléments	/fr/docs/Archive/Mozilla/XUL/Tutoriel_XUL/Ajouter_plus_d'éléments
/fr/docs/Tutoriel_XUL:Arbres	/fr/docs/Archive/Mozilla/XUL/Tutoriel_XUL/Arbres
/fr/docs/Tutoriel_XUL:Arbres_et_Gabarits	/fr/docs/Archive/Mozilla/XUL/Tutoriel_XUL/Arbres_et_Gabarits
/fr/docs/Tutoriel_XUL:Assistant_avançé	/fr/docs/Archive/Mozilla/XUL/Tutoriel_XUL/Assistant_avançé
/fr/docs/Tutoriel_XUL:Autres_caractéristiques_des_arbres	/fr/docs/Archive/Mozilla/XUL/Tutoriel_XUL/Autres_caractéristiques_des_arbres
/fr/docs/Tutoriel_XUL:Barres_de_défilement	/fr/docs/Archive/Mozilla/XUL/Tutoriel_XUL/Barres_de_défilement
/fr/docs/Tutoriel_XUL:Barres_de_menus_simples	/fr/docs/Archive/Mozilla/XUL/Tutoriel_XUL/Barres_de_menus_simples
/fr/docs/Tutoriel_XUL:Boîte_de_dialogue_de_fichier	/fr/docs/Archive/Mozilla/XUL/Tutoriel_XUL/Boîte_de_dialogue_de_fichier
/fr/docs/Tutoriel_XUL:Broadcasters_et_Observateurs	/fr/docs/Archive/Mozilla/XUL/Tutoriel_XUL/Broadcasters_et_Observateurs
/fr/docs/Tutoriel_XUL:Cadres_de_contenu	/fr/docs/Archive/Mozilla/XUL/Tutoriel_XUL/Cadres_de_contenu
/fr/docs/Tutoriel_XUL:Caractéristiques_d'une_fenêtre	/fr/docs/Archive/Mozilla/XUL/Tutoriel_XUL/Caractéristiques_d'une_fenêtre
/fr/docs/Tutoriel_XUL:Commandes	/fr/docs/Archive/Mozilla/XUL/Tutoriel_XUL/Commandes
/fr/docs/Tutoriel_XUL:Contenu_anonyme	/fr/docs/Archive/Mozilla/XUL/Tutoriel_XUL/Contenu_anonyme
/fr/docs/Tutoriel_XUL:Création_d'un_assistant	/fr/docs/Archive/Mozilla/XUL/Tutoriel_XUL/Création_d'un_assistant
/fr/docs/Tutoriel_XUL:Création_d'un_programme_d'installation	/fr/docs/Archive/Mozilla/XUL/Tutoriel_XUL/Création_d'un_programme_d'installation
/fr/docs/Tutoriel_XUL:Créer_des_boîtes_de_dialogue	/fr/docs/Archive/Mozilla/XUL/Tutoriel_XUL/Créer_des_boîtes_de_dialogue
/fr/docs/Tutoriel_XUL:Créer_un_thème	/fr/docs/Archive/Mozilla/XUL/Tutoriel_XUL/Créer_un_thème
/fr/docs/Tutoriel_XUL:Créer_une_fenêtre	/fr/docs/Archive/Mozilla/XUL/Tutoriel_XUL/Créer_une_fenêtre
/fr/docs/Tutoriel_XUL:Document_Object_Model	/fr/docs/Archive/Mozilla/XUL/Tutoriel_XUL/Document_Object_Model
/fr/docs/Tutoriel_XUL:Données_persistantes	/fr/docs/Archive/Mozilla/XUL/Tutoriel_XUL/Données_persistantes
/fr/docs/Tutoriel_XUL:Détails_sur_le_modèle_de_boîte	/fr/docs/Archive/Mozilla/XUL/Tutoriel_XUL/Détails_sur_le_modèle_de_boîte
/fr/docs/Tutoriel_XUL:Détails_sur_les_vues_d'arbres	/fr/docs/Archive/Mozilla/XUL/Tutoriel_XUL/Détails_sur_les_vues_d'arbres
/fr/docs/Tutoriel_XUL:Exemple_XBL	/fr/docs/Archive/Mozilla/XUL/Tutoriel_XUL/Exemple_XBL
/fr/docs/Tutoriel_XUL:Exemples_XPCOM	/fr/docs/Archive/Mozilla/XUL/Tutoriel_XUL/Exemples_XPCOM
/fr/docs/Tutoriel_XUL:Focus_et_Selection	/fr/docs/Archive/Mozilla/XUL/Tutoriel_XUL/Focus_et_Selection
/fr/docs/Tutoriel_XUL:Fonctions_additionnelles_d'installation	/fr/docs/Archive/Mozilla/XUL/Tutoriel_XUL/Fonctions_additionnelles_d'installation
/fr/docs/Tutoriel_XUL:Gabarits	/fr/docs/Archive/Mozilla/XUL/Tutoriel_XUL/Gabarits
/fr/docs/Tutoriel_XUL:Grilles	/fr/docs/Archive/Mozilla/XUL/Tutoriel_XUL/Grilles
/fr/docs/Tutoriel_XUL:Héritage_XBL	/fr/docs/Archive/Mozilla/XUL/Tutoriel_XUL/Héritage_XBL
/fr/docs/Tutoriel_XUL:Héritage_d'attributs_XBL	/fr/docs/Archive/Mozilla/XUL/Tutoriel_XUL/Héritage_d'attributs_XBL
/fr/docs/Tutoriel_XUL:Indicateurs_de_progression	/fr/docs/Archive/Mozilla/XUL/Tutoriel_XUL/Indicateurs_de_progression
/fr/docs/Tutoriel_XUL:Interfaces_XPCOM	/fr/docs/Archive/Mozilla/XUL/Tutoriel_XUL/Interfaces_XPCOM
/fr/docs/Tutoriel_XUL:Introduction	/fr/docs/Archive/Mozilla/XUL/Tutoriel_XUL/Introduction
/fr/docs/Tutoriel_XUL:Introduction_à_RDF	/fr/docs/Archive/Mozilla/XUL/Tutoriel_XUL/Introduction_à_RDF
/fr/docs/Tutoriel_XUL:Introduction_à_XBL	/fr/docs/Archive/Mozilla/XUL/Tutoriel_XUL/Introduction_à_XBL
/fr/docs/Tutoriel_XUL:L'URL_Chrome	/fr/docs/Archive/Mozilla/XUL/Tutoriel_XUL/L'URL_Chrome
/fr/docs/Tutoriel_XUL:La_structure_XUL	/fr/docs/Archive/Mozilla/XUL/Tutoriel_XUL/La_structure_XUL
/fr/docs/Tutoriel_XUL:Le_modèle_de_boîte	/fr/docs/Archive/Mozilla/XUL/Tutoriel_XUL/Le_modèle_de_boîte
/fr/docs/Tutoriel_XUL:Les_boîtes_de_groupe	/fr/docs/Archive/Mozilla/XUL/Tutoriel_XUL/Les_boîtes_de_groupe
/fr/docs/Tutoriel_XUL:Les_champs_de_saisie	/fr/docs/Archive/Mozilla/XUL/Tutoriel_XUL/Les_champs_de_saisie
/fr/docs/Tutoriel_XUL:Les_contrôles_de_listes	/fr/docs/Archive/Mozilla/XUL/Tutoriel_XUL/Les_contrôles_de_listes
/fr/docs/Tutoriel_XUL:Les_contrôles_numériques	/fr/docs/Archive/Mozilla/XUL/Tutoriel_XUL/Les_contrôles_numériques
/fr/docs/Tutoriel_XUL:Les_fichiers_de_propriétés	/fr/docs/Archive/Mozilla/XUL/Tutoriel_XUL/Les_fichiers_de_propriétés
/fr/docs/Tutoriel_XUL:Les_fichiers_manifest	/fr/docs/Archive/Mozilla/XUL/Tutoriel_XUL/Les_fichiers_manifest
/fr/docs/Tutoriel_XUL:Les_objets_boîtes	/fr/docs/Archive/Mozilla/XUL/Tutoriel_XUL/Les_objets_boîtes
/fr/docs/Tutoriel_XUL:Les_objets_boîtes_des_arbres	/fr/docs/Archive/Mozilla/XUL/Tutoriel_XUL/Les_objets_boîtes_des_arbres
/fr/docs/Tutoriel_XUL:Les_scripts_d'installation	/fr/docs/Archive/Mozilla/XUL/Tutoriel_XUL/Les_scripts_d'installation
/fr/docs/Tutoriel_XUL:Localisation	/fr/docs/Archive/Mozilla/XUL/Tutoriel_XUL/Localisation
/fr/docs/Tutoriel_XUL:Manipulation_de_listes	/fr/docs/Archive/Mozilla/XUL/Tutoriel_XUL/Manipulation_de_listes
/fr/docs/Tutoriel_XUL:Menus_défilants	/fr/docs/Archive/Mozilla/XUL/Tutoriel_XUL/Menus_défilants
/fr/docs/Tutoriel_XUL:Menus_surgissants	/fr/docs/Archive/Mozilla/XUL/Tutoriel_XUL/Menus_surgissants
/fr/docs/Tutoriel_XUL:Mise_à_jour_de_commandes	/fr/docs/Archive/Mozilla/XUL/Tutoriel_XUL/Mise_à_jour_de_commandes
/fr/docs/Tutoriel_XUL:Modification_d'une_interface_XUL	/fr/docs/Archive/Mozilla/XUL/Tutoriel_XUL/Modification_d'une_interface_XUL
/fr/docs/Tutoriel_XUL:Modification_du_thème_par_défaut	/fr/docs/Archive/Mozilla/XUL/Tutoriel_XUL/Modification_du_thème_par_défaut
/fr/docs/Tutoriel_XUL:Onglets	/fr/docs/Archive/Mozilla/XUL/Tutoriel_XUL/Onglets
/fr/docs/Tutoriel_XUL:Overlays	/fr/docs/Mozilla/Tech/XUL/Tutoriel_XUL/Overlays
/fr/docs/Tutoriel_XUL:Overlays_inter-paquetage	/fr/docs/Archive/Mozilla/XUL/Tutoriel_XUL/Overlays_inter-paquetage
/fr/docs/Tutoriel_XUL:Piles_et_Paquets	/fr/docs/Archive/Mozilla/XUL/Tutoriel_XUL/Piles_et_Paquets
/fr/docs/Tutoriel_XUL:Plus_de_caractéristiques_sur_les_boutons	/fr/docs/Archive/Mozilla/XUL/Tutoriel_XUL/Plus_de_caractéristiques_sur_les_boutons
/fr/docs/Tutoriel_XUL:Plus_de_fonctionnalités_de_menu	/fr/docs/Archive/Mozilla/XUL/Tutoriel_XUL/Plus_de_fonctionnalités_de_menu
/fr/docs/Tutoriel_XUL:Plus_sur_les_gestionnaires_d'évènements	/fr/docs/Archive/Mozilla/XUL/Tutoriel_XUL/Plus_sur_les_gestionnaires_d'évènements
/fr/docs/Tutoriel_XUL:Positionnement_dans_une_pile	/fr/docs/Archive/Mozilla/XUL/Tutoriel_XUL/Positionnement_dans_une_pile
/fr/docs/Tutoriel_XUL:Positionnement_des_éléments	/fr/docs/Archive/Mozilla/XUL/Tutoriel_XUL/Positionnement_des_éléments
/fr/docs/Tutoriel_XUL:Raccourcis_clavier	/fr/docs/Archive/Mozilla/XUL/Tutoriel_XUL/Raccourcis_clavier
/fr/docs/Tutoriel_XUL:Règles_avançées	/fr/docs/Archive/Mozilla/XUL/Tutoriel_XUL/Règles_avançées
/fr/docs/Tutoriel_XUL:Sources_de_données_RDF	/fr/docs/Archive/Mozilla/XUL/Tutoriel_XUL/Sources_de_données_RDF
/fr/docs/Tutoriel_XUL:Styler_un_arbre	/fr/docs/Archive/Mozilla/XUL/Tutoriel_XUL/Styler_un_arbre
/fr/docs/Tutoriel_XUL:Sélection_dans_les_arbres	/fr/docs/Archive/Mozilla/XUL/Tutoriel_XUL/Sélection_dans_les_arbres
/fr/docs/Tutoriel_XUL:Séparateurs	/fr/docs/Archive/Mozilla/XUL/Tutoriel_XUL/Séparateurs
/fr/docs/Tutoriel_XUL:Utilisation_des_spacers	/fr/docs/Archive/Mozilla/XUL/Tutoriel_XUL/Utilisation_des_spacers
/fr/docs/Tutoriel_XUL:Vues_d'arbre_personnalisées	/fr/docs/Archive/Mozilla/XUL/Tutoriel_XUL/Vues_d'arbre_personnalisées
/fr/docs/Télécharger_du_JSON_et_du_JavaScript_dans_une_extension	/fr/docs/Archive/Add-ons/Télécharger_du_JSON_et_du_JavaScript_dans_une_extension
/fr/docs/Utilisation_de_Data_Islands_XML_dans_Mozilla	/fr/docs/Archive/Misc_top_level/Utilisation_de_Data_Islands_XML_dans_Mozilla
/fr/docs/Utilisation_de_microformats	/fr/docs/Archive/Mozilla/Firefox/Utilisation_de_microformats
/fr/docs/Utilisation_de_nsIXULAppInfo	/fr/docs/Archive/Mozilla/XUL/Utilisation_de_nsIXULAppInfo
/fr/docs/Utilisation_de_plusieurs_DTD	/fr/docs/Archive/Mozilla/XUL/Utilisation_de_plusieurs_DTD
/fr/docs/Utilisation_des_préférences_de_contenu	/fr/docs/Archive/Misc_top_level/Utilisation_des_préférences_de_contenu
/fr/docs/Utilisation_du_correcteur_orthographique_dans_XUL	/fr/docs/Archive/Mozilla/XUL/Utilisation_du_correcteur_orthographique_dans_XUL
/fr/docs/Utiliser_des_titres_corrects_avec_des_feuilles_de_styles_externes	/fr/docs/Archive/Standards_du_Web/Utiliser_des_titres_corrects_avec_des_feuilles_de_styles_externes
/fr/docs/Versions_extension,_mise_à_jour_et_compatibilité	/fr/docs/Archive/Add-ons/Versions_extension,_mise_à_jour_et_compatibilité
/fr/docs/Visualisation_et_recherche_du_code_source_Mozilla_en_ligne	/fr/docs/Mozilla/Tech/Visualisation_et_recherche_du_code_source_Mozilla_en_ligne
/fr/docs/Vulgarisation_XUL	/fr/docs/Archive/Mozilla/XUL/Vulgarisation_XUL
/fr/docs/Vulgarisation_XUL/Introduction	/fr/docs/Archive/Mozilla/XUL/Vulgarisation_XUL/Introduction
/fr/docs/Vulgarisation_XUL/L'essentiel_d'une_extension	/fr/docs/Archive/Mozilla/XUL/Vulgarisation_XUL/L'essentiel_d'une_extension
/fr/docs/Vulgarisation_XUL/Premiers_pas_avec_les_extensions_Firefox	/fr/docs/Archive/Mozilla/XUL/Vulgarisation_XUL/Premiers_pas_avec_les_extensions_Firefox
/fr/docs/Web/API/App	/fr/docs/Archive/B2G_OS/API/DOMApplication
/fr/docs/Web/API/Apps	/fr/docs/Archive/Marketplace/API/DOMApplicationsRegistry
/fr/docs/Web/API/Apps.getInstalled	/fr/docs/Archive/Marketplace/API/DOMApplicationsRegistry/getInstalled
/fr/docs/Web/API/Apps.getSelf	/fr/docs/Archive/Marketplace/API/DOMApplicationsRegistry/getSelf
/fr/docs/Web/API/Apps.install	/fr/docs/Archive/Marketplace/API/DOMApplicationsRegistry/install
/fr/docs/Web/API/BluetoothStatusChangedEvent	/fr/docs/Archive/B2G_OS/API/BluetoothStatusChangedEvent
/fr/docs/Web/API/CallEvent	/fr/docs/Archive/B2G_OS/API/CallEvent
/fr/docs/Web/API/DOMApplication	/fr/docs/Archive/B2G_OS/API/DOMApplication
/fr/docs/Web/API/DOMApplicationsRegistry	/fr/docs/Archive/Marketplace/API/DOMApplicationsRegistry
/fr/docs/Web/API/DOMApplicationsRegistry/getInstalled	/fr/docs/Archive/Marketplace/API/DOMApplicationsRegistry/getInstalled
/fr/docs/Web/API/DOMApplicationsRegistry/getSelf	/fr/docs/Archive/Marketplace/API/DOMApplicationsRegistry/getSelf
/fr/docs/Web/API/DOMApplicationsRegistry/install	/fr/docs/Archive/Marketplace/API/DOMApplicationsRegistry/install
/fr/docs/Web/API/DOMRequest	/fr/docs/Archive/B2G_OS/API/DOMRequest
/fr/docs/Web/API/DOMRequest.error	/fr/docs/Archive/B2G_OS/API/DOMRequest/error
/fr/docs/Web/API/DOMRequest.onerror	/fr/docs/Archive/B2G_OS/API/DOMRequest/onerror
/fr/docs/Web/API/DOMRequest.onsuccess	/fr/docs/Archive/B2G_OS/API/DOMRequest/onsuccess
/fr/docs/Web/API/DOMRequest.readyState	/fr/docs/Archive/B2G_OS/API/DOMRequest/readyState
/fr/docs/Web/API/DOMRequest.result	/fr/docs/Archive/B2G_OS/API/DOMRequest/result
/fr/docs/Web/API/DOMRequest/error	/fr/docs/Archive/B2G_OS/API/DOMRequest/error
/fr/docs/Web/API/DOMRequest/onerror	/fr/docs/Archive/B2G_OS/API/DOMRequest/onerror
/fr/docs/Web/API/DOMRequest/onsuccess	/fr/docs/Archive/B2G_OS/API/DOMRequest/onsuccess
/fr/docs/Web/API/DOMRequest/readyState	/fr/docs/Archive/B2G_OS/API/DOMRequest/readyState
/fr/docs/Web/API/DOMRequest/result	/fr/docs/Archive/B2G_OS/API/DOMRequest/result
/fr/docs/Web/API/MozContact/honorificSuffix	/fr/docs/Archive/B2G_OS/API/honorificSuffix
/fr/docs/Web/API/Navigator.addIdleObserver	/fr/docs/Archive/B2G_OS/API/Navigator/addIdleObserver
/fr/docs/Web/API/Navigator.mozApps	/fr/docs/Archive/B2G_OS/API/Navigator/mozApps
/fr/docs/Web/API/Navigator/addIdleObserver	/fr/docs/Archive/B2G_OS/API/Navigator/addIdleObserver
/fr/docs/Web/API/Navigator/mozApps	/fr/docs/Archive/B2G_OS/API/Navigator/mozApps
/fr/docs/Web/API/Navigator/requestWakeLock	/fr/docs/Archive/B2G_OS/API/Navigator/requestWakeLock
/fr/docs/Web/API/mozContact.honorificSuffix	/fr/docs/Archive/B2G_OS/API/honorificSuffix
/fr/docs/Web/API/window.navigator.requestWakeLock	/fr/docs/Archive/B2G_OS/API/Navigator/requestWakeLock
/fr/docs/Web/Apps/Quickstart/Build	/fr/docs/Archive/B2G_OS/Quickstart
/fr/docs/Web/Apps/Quickstart/Build/Votre_premier_application	/fr/docs/Archive/B2G_OS/Quickstart/Votre_premier_application
/fr/docs/Web/Apps/Sujets_avancés	/fr/docs/Archive/Apps/Advanced_topics
/fr/docs/Web/CSS/-moz-window-dragging	/fr/docs/Mozilla/Gecko/Chrome/CSS/-moz-window-dragging
/fr/docs/Web/CSS/:-moz-tree-cell	/fr/docs/Mozilla/Gecko/Chrome/CSS/::-moz-tree-cell
/fr/docs/Web/CSS/:-moz-tree-cell-text	/fr/docs/Mozilla/Gecko/Chrome/CSS/::-moz-tree-cell-text
/fr/docs/Web/CSS/:-moz-tree-cell-text(hover)	/fr/docs/Mozilla/Gecko/Chrome/CSS/::-moz-tree-cell-text(hover)
/fr/docs/Web/CSS/:-moz-tree-column	/fr/docs/Mozilla/Gecko/Chrome/CSS/::-moz-tree-column
/fr/docs/Web/CSS/:-moz-tree-drop-feedback	/fr/docs/Mozilla/Gecko/Chrome/CSS/::-moz-tree-drop-feedback
/fr/docs/Web/CSS/:-moz-tree-image	/fr/docs/Mozilla/Gecko/Chrome/CSS/::-moz-tree-image
/fr/docs/Web/CSS/:-moz-tree-indentation	/fr/docs/Mozilla/Gecko/Chrome/CSS/::-moz-tree-indentation
/fr/docs/Web/CSS/:-moz-tree-line	/fr/docs/Mozilla/Gecko/Chrome/CSS/::-moz-tree-line
/fr/docs/Web/CSS/:-moz-tree-progressmeter	/fr/docs/Mozilla/Gecko/Chrome/CSS/::-moz-tree-progressmeter
/fr/docs/Web/CSS/:-moz-tree-row	/fr/docs/Mozilla/Gecko/Chrome/CSS/::-moz-tree-row
/fr/docs/Web/CSS/:-moz-tree-row(hover)	/fr/docs/Mozilla/Gecko/Chrome/CSS/::-moz-tree-row(hover)
/fr/docs/Web/CSS/:-moz-tree-separator	/fr/docs/Mozilla/Gecko/Chrome/CSS/::-moz-tree-separator
/fr/docs/Web/CSS/:-moz-tree-twisty	/fr/docs/Mozilla/Gecko/Chrome/CSS/::-moz-tree-twisty
/fr/docs/Web/CSS/CSS3	/fr/docs/Archive/CSS3
/fr/docs/Web/CSS/Problèmes_soulevés_par_le_pseudo_élément_hover	/fr/docs/Archive/Standards_du_Web/Problèmes_soulevés_par_le_pseudo_élément_hover
/fr/docs/Web/Events/deviceproximity	/fr/docs/Archive/deviceproximity
/fr/docs/Web/Guide/Telephony	/fr/docs/Archive/B2G_OS/Web_Telephony_API
/fr/docs/Web/JavaScript/Extensions_JavaScript_Microsoft	/fr/docs/Archive/Web/JavaScript/Extensions_Microsoft
/fr/docs/Web/JavaScript/Extensions_JavaScript_Microsoft/ActiveXObject	/fr/docs/Archive/Web/JavaScript/Extensions_Microsoft/ActiveXObject
/fr/docs/Web/JavaScript/Extensions_JavaScript_Microsoft/Date.getVarDate	/fr/docs/Archive/Web/JavaScript/Extensions_Microsoft/Date.getVarDate
/fr/docs/Web/JavaScript/Extensions_JavaScript_Microsoft/Debug	/fr/docs/Archive/Web/JavaScript/Extensions_Microsoft/Debug
/fr/docs/Web/JavaScript/Extensions_JavaScript_Microsoft/Debug/debuggerEnabled	/fr/docs/Archive/Web/JavaScript/Extensions_Microsoft/Debug/debuggerEnabled
/fr/docs/Web/JavaScript/Extensions_JavaScript_Microsoft/Debug/msTraceAsyncCallbackCompleted	/fr/docs/Archive/Web/JavaScript/Extensions_Microsoft/Debug/msTraceAsyncCallbackCompleted
/fr/docs/Web/JavaScript/Extensions_JavaScript_Microsoft/Debug/msTraceAsyncCallbackStarting	/fr/docs/Archive/Web/JavaScript/Extensions_Microsoft/Debug/msTraceAsyncCallbackStarting
/fr/docs/Web/JavaScript/Extensions_JavaScript_Microsoft/Debug/msTraceAsyncOperationCompleted	/fr/docs/Archive/Web/JavaScript/Extensions_Microsoft/Debug/msTraceAsyncOperationCompleted
/fr/docs/Web/JavaScript/Extensions_JavaScript_Microsoft/Debug/msTraceAsyncOperationStarting	/fr/docs/Archive/Web/JavaScript/Extensions_Microsoft/Debug/msTraceAsyncOperationStarting
/fr/docs/Web/JavaScript/Extensions_JavaScript_Microsoft/Debug/msUpdateAsyncCallbackRelation	/fr/docs/Archive/Web/JavaScript/Extensions_Microsoft/Debug/msUpdateAsyncCallbackRelation
/fr/docs/Web/JavaScript/Extensions_JavaScript_Microsoft/Debug/setNonUserCodeExceptions	/fr/docs/Archive/Web/JavaScript/Extensions_Microsoft/Debug/setNonUserCodeExceptions
/fr/docs/Web/JavaScript/Extensions_JavaScript_Microsoft/Debug/write	/fr/docs/Archive/Web/JavaScript/Extensions_Microsoft/Debug/write
/fr/docs/Web/JavaScript/Extensions_JavaScript_Microsoft/Debug/writeln	/fr/docs/Archive/Web/JavaScript/Extensions_Microsoft/Debug/writeln
/fr/docs/Web/JavaScript/Extensions_JavaScript_Microsoft/Enumerator	/fr/docs/Archive/Web/JavaScript/Extensions_Microsoft/Enumerator
/fr/docs/Web/JavaScript/Extensions_JavaScript_Microsoft/Enumerator/atEnd	/fr/docs/Archive/Web/JavaScript/Extensions_Microsoft/Enumerator/atEnd
/fr/docs/Web/JavaScript/Extensions_JavaScript_Microsoft/Enumerator/item	/fr/docs/Archive/Web/JavaScript/Extensions_Microsoft/Enumerator/item
/fr/docs/Web/JavaScript/Extensions_JavaScript_Microsoft/Enumerator/moveFirst	/fr/docs/Archive/Web/JavaScript/Extensions_Microsoft/Enumerator/moveFirst
/fr/docs/Web/JavaScript/Extensions_JavaScript_Microsoft/Enumerator/moveNext	/fr/docs/Archive/Web/JavaScript/Extensions_Microsoft/Enumerator/moveNext
/fr/docs/Web/JavaScript/Extensions_JavaScript_Microsoft/Error.description	/fr/docs/Archive/Web/JavaScript/Extensions_Microsoft/Error.description
/fr/docs/Web/JavaScript/Extensions_JavaScript_Microsoft/Error.number	/fr/docs/Archive/Web/JavaScript/Extensions_Microsoft/Error.number
/fr/docs/Web/JavaScript/Extensions_JavaScript_Microsoft/Error.stackTraceLimit	/fr/docs/Archive/Web/JavaScript/Extensions_Microsoft/Error.stackTraceLimit
/fr/docs/Web/JavaScript/Extensions_JavaScript_Microsoft/GetObject	/fr/docs/Archive/Web/JavaScript/Extensions_Microsoft/GetObject
/fr/docs/Web/JavaScript/Extensions_JavaScript_Microsoft/ScriptEngine	/fr/docs/Archive/Web/JavaScript/Extensions_Microsoft/ScriptEngine
/fr/docs/Web/JavaScript/Extensions_JavaScript_Microsoft/ScriptEngineBuildVersion	/fr/docs/Archive/Web/JavaScript/Extensions_Microsoft/ScriptEngineBuildVersion
/fr/docs/Web/JavaScript/Extensions_JavaScript_Microsoft/ScriptEngineMajorVersion	/fr/docs/Archive/Web/JavaScript/Extensions_Microsoft/ScriptEngineMajorVersion
/fr/docs/Web/JavaScript/Extensions_JavaScript_Microsoft/ScriptEngineMinorVersion	/fr/docs/Archive/Web/JavaScript/Extensions_Microsoft/ScriptEngineMinorVersion
/fr/docs/Web/JavaScript/Extensions_JavaScript_Microsoft/VBArray	/fr/docs/Archive/Web/JavaScript/Extensions_Microsoft/VBArray
/fr/docs/Web/JavaScript/Extensions_JavaScript_Microsoft/VBArray/dimensions	/fr/docs/Archive/Web/JavaScript/Extensions_Microsoft/VBArray/dimensions
/fr/docs/Web/JavaScript/Extensions_JavaScript_Microsoft/VBArray/getItem	/fr/docs/Archive/Web/JavaScript/Extensions_Microsoft/VBArray/getItem
/fr/docs/Web/JavaScript/Extensions_JavaScript_Microsoft/VBArray/lbound	/fr/docs/Archive/Web/JavaScript/Extensions_Microsoft/VBArray/lbound
/fr/docs/Web/JavaScript/Extensions_JavaScript_Microsoft/VBArray/toArray	/fr/docs/Archive/Web/JavaScript/Extensions_Microsoft/VBArray/toArray
/fr/docs/Web/JavaScript/Extensions_JavaScript_Microsoft/VBArray/ubound	/fr/docs/Archive/Web/JavaScript/Extensions_Microsoft/VBArray/ubound
/fr/docs/Web/JavaScript/Extensions_JavaScript_Microsoft/at-cc-on	/fr/docs/Archive/Web/JavaScript/Extensions_Microsoft/at-cc-on
/fr/docs/Web/JavaScript/Extensions_JavaScript_Microsoft/at-if	/fr/docs/Archive/Web/JavaScript/Extensions_Microsoft/at-if
/fr/docs/Web/JavaScript/Extensions_JavaScript_Microsoft/at-set	/fr/docs/Archive/Web/JavaScript/Extensions_Microsoft/at-set
/fr/docs/Web/JavaScript/Extensions_Microsoft	/fr/docs/Archive/Web/JavaScript/Extensions_Microsoft
/fr/docs/Web/JavaScript/Extensions_Microsoft/ActiveXObject	/fr/docs/Archive/Web/JavaScript/Extensions_Microsoft/ActiveXObject
/fr/docs/Web/JavaScript/Extensions_Microsoft/Date.getVarDate	/fr/docs/Archive/Web/JavaScript/Extensions_Microsoft/Date.getVarDate
/fr/docs/Web/JavaScript/Extensions_Microsoft/Debug	/fr/docs/Archive/Web/JavaScript/Extensions_Microsoft/Debug
/fr/docs/Web/JavaScript/Extensions_Microsoft/Debug/debuggerEnabled	/fr/docs/Archive/Web/JavaScript/Extensions_Microsoft/Debug/debuggerEnabled
/fr/docs/Web/JavaScript/Extensions_Microsoft/Debug/msTraceAsyncCallbackCompleted	/fr/docs/Archive/Web/JavaScript/Extensions_Microsoft/Debug/msTraceAsyncCallbackCompleted
/fr/docs/Web/JavaScript/Extensions_Microsoft/Debug/msTraceAsyncCallbackStarting	/fr/docs/Archive/Web/JavaScript/Extensions_Microsoft/Debug/msTraceAsyncCallbackStarting
/fr/docs/Web/JavaScript/Extensions_Microsoft/Debug/msTraceAsyncOperationCompleted	/fr/docs/Archive/Web/JavaScript/Extensions_Microsoft/Debug/msTraceAsyncOperationCompleted
/fr/docs/Web/JavaScript/Extensions_Microsoft/Debug/msTraceAsyncOperationStarting	/fr/docs/Archive/Web/JavaScript/Extensions_Microsoft/Debug/msTraceAsyncOperationStarting
/fr/docs/Web/JavaScript/Extensions_Microsoft/Debug/msUpdateAsyncCallbackRelation	/fr/docs/Archive/Web/JavaScript/Extensions_Microsoft/Debug/msUpdateAsyncCallbackRelation
/fr/docs/Web/JavaScript/Extensions_Microsoft/Debug/setNonUserCodeExceptions	/fr/docs/Archive/Web/JavaScript/Extensions_Microsoft/Debug/setNonUserCodeExceptions
/fr/docs/Web/JavaScript/Extensions_Microsoft/Debug/write	/fr/docs/Archive/Web/JavaScript/Extensions_Microsoft/Debug/write
/fr/docs/Web/JavaScript/Extensions_Microsoft/Debug/writeln	/fr/docs/Archive/Web/JavaScript/Extensions_Microsoft/Debug/writeln
/fr/docs/Web/JavaScript/Extensions_Microsoft/Enumerator	/fr/docs/Archive/Web/JavaScript/Extensions_Microsoft/Enumerator
/fr/docs/Web/JavaScript/Extensions_Microsoft/Enumerator/atEnd	/fr/docs/Archive/Web/JavaScript/Extensions_Microsoft/Enumerator/atEnd
/fr/docs/Web/JavaScript/Extensions_Microsoft/Enumerator/item	/fr/docs/Archive/Web/JavaScript/Extensions_Microsoft/Enumerator/item
/fr/docs/Web/JavaScript/Extensions_Microsoft/Enumerator/moveFirst	/fr/docs/Archive/Web/JavaScript/Extensions_Microsoft/Enumerator/moveFirst
/fr/docs/Web/JavaScript/Extensions_Microsoft/Enumerator/moveNext	/fr/docs/Archive/Web/JavaScript/Extensions_Microsoft/Enumerator/moveNext
/fr/docs/Web/JavaScript/Extensions_Microsoft/Error.description	/fr/docs/Archive/Web/JavaScript/Extensions_Microsoft/Error.description
/fr/docs/Web/JavaScript/Extensions_Microsoft/Error.number	/fr/docs/Archive/Web/JavaScript/Extensions_Microsoft/Error.number
/fr/docs/Web/JavaScript/Extensions_Microsoft/Error.stackTraceLimit	/fr/docs/Archive/Web/JavaScript/Extensions_Microsoft/Error.stackTraceLimit
/fr/docs/Web/JavaScript/Extensions_Microsoft/GetObject	/fr/docs/Archive/Web/JavaScript/Extensions_Microsoft/GetObject
/fr/docs/Web/JavaScript/Extensions_Microsoft/ScriptEngine	/fr/docs/Archive/Web/JavaScript/Extensions_Microsoft/ScriptEngine
/fr/docs/Web/JavaScript/Extensions_Microsoft/ScriptEngineBuildVersion	/fr/docs/Archive/Web/JavaScript/Extensions_Microsoft/ScriptEngineBuildVersion
/fr/docs/Web/JavaScript/Extensions_Microsoft/ScriptEngineMajorVersion	/fr/docs/Archive/Web/JavaScript/Extensions_Microsoft/ScriptEngineMajorVersion
/fr/docs/Web/JavaScript/Extensions_Microsoft/ScriptEngineMinorVersion	/fr/docs/Archive/Web/JavaScript/Extensions_Microsoft/ScriptEngineMinorVersion
/fr/docs/Web/JavaScript/Extensions_Microsoft/VBArray	/fr/docs/Archive/Web/JavaScript/Extensions_Microsoft/VBArray
/fr/docs/Web/JavaScript/Extensions_Microsoft/VBArray/dimensions	/fr/docs/Archive/Web/JavaScript/Extensions_Microsoft/VBArray/dimensions
/fr/docs/Web/JavaScript/Extensions_Microsoft/VBArray/getItem	/fr/docs/Archive/Web/JavaScript/Extensions_Microsoft/VBArray/getItem
/fr/docs/Web/JavaScript/Extensions_Microsoft/VBArray/lbound	/fr/docs/Archive/Web/JavaScript/Extensions_Microsoft/VBArray/lbound
/fr/docs/Web/JavaScript/Extensions_Microsoft/VBArray/toArray	/fr/docs/Archive/Web/JavaScript/Extensions_Microsoft/VBArray/toArray
/fr/docs/Web/JavaScript/Extensions_Microsoft/VBArray/ubound	/fr/docs/Archive/Web/JavaScript/Extensions_Microsoft/VBArray/ubound
/fr/docs/Web/JavaScript/Extensions_Microsoft/at-cc-on	/fr/docs/Archive/Web/JavaScript/Extensions_Microsoft/at-cc-on
/fr/docs/Web/JavaScript/Extensions_Microsoft/at-if	/fr/docs/Archive/Web/JavaScript/Extensions_Microsoft/at-if
/fr/docs/Web/JavaScript/Extensions_Microsoft/at-set	/fr/docs/Archive/Web/JavaScript/Extensions_Microsoft/at-set
/fr/docs/Web/JavaScript/Microsoft_JavaScript_extensions/Debug	/fr/docs/Archive/Web/JavaScript/Extensions_Microsoft/Debug
/fr/docs/Web/JavaScript/Microsoft_JavaScript_extensions/Debug/debuggerEnabled	/fr/docs/Archive/Web/JavaScript/Extensions_Microsoft/Debug/debuggerEnabled
/fr/docs/Web/JavaScript/Microsoft_JavaScript_extensions/Debug/msTraceAsyncCallbackCompleted	/fr/docs/Archive/Web/JavaScript/Extensions_Microsoft/Debug/msTraceAsyncCallbackCompleted
/fr/docs/Web/JavaScript/Microsoft_JavaScript_extensions/Debug/msTraceAsyncCallbackStarting	/fr/docs/Archive/Web/JavaScript/Extensions_Microsoft/Debug/msTraceAsyncCallbackStarting
/fr/docs/Web/JavaScript/Microsoft_JavaScript_extensions/Debug/msTraceAsyncOperationCompleted	/fr/docs/Archive/Web/JavaScript/Extensions_Microsoft/Debug/msTraceAsyncOperationCompleted
/fr/docs/Web/JavaScript/Microsoft_JavaScript_extensions/Debug/msTraceAsyncOperationStarting	/fr/docs/Archive/Web/JavaScript/Extensions_Microsoft/Debug/msTraceAsyncOperationStarting
/fr/docs/Web/JavaScript/Microsoft_JavaScript_extensions/Debug/msUpdateAsyncCallbackRelation	/fr/docs/Archive/Web/JavaScript/Extensions_Microsoft/Debug/msUpdateAsyncCallbackRelation
/fr/docs/Web/JavaScript/Microsoft_JavaScript_extensions/Debug/setNonUserCodeExceptions	/fr/docs/Archive/Web/JavaScript/Extensions_Microsoft/Debug/setNonUserCodeExceptions
/fr/docs/Web/JavaScript/Microsoft_JavaScript_extensions/Debug/write	/fr/docs/Archive/Web/JavaScript/Extensions_Microsoft/Debug/write
/fr/docs/Web/JavaScript/Microsoft_JavaScript_extensions/Debug/writeln	/fr/docs/Archive/Web/JavaScript/Extensions_Microsoft/Debug/writeln
/fr/docs/Web/JavaScript/Microsoft_JavaScript_extensions/Enumerator/moveNext	/fr/docs/Archive/Web/JavaScript/Extensions_Microsoft/Enumerator/moveNext
/fr/docs/Web/JavaScript/Microsoft_JavaScript_extensions/VBArray/ubound	/fr/docs/Archive/Web/JavaScript/Extensions_Microsoft/VBArray/ubound
/fr/docs/Web/JavaScript/Nouveautés_et_historique_de_JavaScript/Support_ECMAScript_Next_par_Mozilla	/fr/docs/Archive/Web/JavaScript/Support_ECMAScript_Next_par_Mozilla
/fr/docs/Web/JavaScript/Reference/Enumerator	/fr/docs/Archive/Web/JavaScript/Extensions_Microsoft/Enumerator
/fr/docs/Web/JavaScript/Reference/Enumerator/atEnd	/fr/docs/Archive/Web/JavaScript/Extensions_Microsoft/Enumerator/atEnd
/fr/docs/Web/JavaScript/Reference/Enumerator/item	/fr/docs/Archive/Web/JavaScript/Extensions_Microsoft/Enumerator/item
/fr/docs/Web/JavaScript/Reference/Enumerator/moveFirst	/fr/docs/Archive/Web/JavaScript/Extensions_Microsoft/Enumerator/moveFirst
/fr/docs/Web/JavaScript/Reference/Instructions/Fonction_génératrice_historique	/fr/docs/Archive/Web/JavaScript/Fonction_génératrice_historique_statement
/fr/docs/Web/JavaScript/Reference/Objets_globaux/Iterator	/fr/docs/Archive/Web/Iterator
/fr/docs/Web/JavaScript/Reference/Objets_globaux/Proxy/handler/enumerate	/fr/docs/Archive/Web/JavaScript/handler.enumerate
/fr/docs/Web/JavaScript/Reference/Objets_globaux/Reflect/enumerate	/fr/docs/Archive/Web/JavaScript/Reflect.enumerate
/fr/docs/Web/JavaScript/Reference/Opérateurs/Fonction_génératrice_historique	/fr/docs/Archive/Web/JavaScript/Fonction_génératrice_historique
/fr/docs/Web/JavaScript/Reference/VBArray	/fr/docs/Archive/Web/JavaScript/Extensions_Microsoft/VBArray
/fr/docs/Web/JavaScript/Reference/VBArray/dimensions	/fr/docs/Archive/Web/JavaScript/Extensions_Microsoft/VBArray/dimensions
/fr/docs/Web/JavaScript/Reference/VBArray/getItem	/fr/docs/Archive/Web/JavaScript/Extensions_Microsoft/VBArray/getItem
/fr/docs/Web/JavaScript/Reference/VBArray/lbound	/fr/docs/Archive/Web/JavaScript/Extensions_Microsoft/VBArray/lbound
/fr/docs/Web/JavaScript/Reference/VBArray/toArray	/fr/docs/Archive/Web/JavaScript/Extensions_Microsoft/VBArray/toArray
/fr/docs/Web/RSS	/fr/docs/Archive/RSS
/fr/docs/Web/RSS/Autres_ressources	/fr/docs/Archive/RSS/Autres_ressources
/fr/docs/Web/RSS/Element	/fr/docs/Archive/RSS/Éléments
/fr/docs/Web/RSS/Entités	/fr/docs/Archive/RSS/Entités
/fr/docs/Web/RSS/Premiers_pas	/fr/docs/Archive/RSS/Premiers_pas
/fr/docs/Web/RSS/Premiers_pas/Fonctionnement_de_RSS	/fr/docs/Archive/RSS/Premiers_pas/Fonctionnement_de_RSS
/fr/docs/Web/RSS/Premiers_pas/Pourquoi_utiliser_RSS	/fr/docs/Archive/RSS/Premiers_pas/Pourquoi_utiliser_RSS
/fr/docs/Web/RSS/Premiers_pas/Présentation_de_RSS	/fr/docs/Archive/RSS/Premiers_pas/Présentation_de_RSS
/fr/docs/Web/RSS/Premiers_pas/Syndication	/fr/docs/Archive/RSS/Premiers_pas/Syndication
/fr/docs/Web/RSS/Version	/fr/docs/Archive/RSS/Version
/fr/docs/Web/RSS/entity	/fr/docs/Archive/RSS/Entités
/fr/docs/Web/RSS/Éléments	/fr/docs/Archive/RSS/Éléments
/fr/docs/WebAPI/Alarm	/fr/docs/Archive/B2G_OS/API/Alarm_API
/fr/docs/WebAPI/WebBluetooth	/fr/docs/Archive/B2G_OS/Bluetooth_API
/fr/docs/When_To_Use_ifdefs	/fr/docs/Archive/Mozilla/When_To_Use_ifdefs
/fr/docs/XBL	/fr/docs/Archive/Mozilla/XBL
/fr/docs/XBL/Référence_XBL_1.0	/fr/docs/Archive/Mozilla/XBL/Référence_XBL_1.0
/fr/docs/XBL/Référence_XBL_1.0/Éléments	/fr/docs/Archive/Mozilla/XBL/Référence_XBL_1.0/Éléments
/fr/docs/XBL:Référence_XBL_1.0	/fr/docs/Archive/Mozilla/XBL/Référence_XBL_1.0
/fr/docs/XBL:Référence_XBL_1.0:Éléments	/fr/docs/Archive/Mozilla/XBL/Référence_XBL_1.0/Éléments
/fr/docs/XForms	/fr/docs/Archive/Web/XForms
/fr/docs/XForms/Autres_ressources	/fr/docs/Archive/Web/XForms/Autres_ressources
/fr/docs/XForms/Préférences_utilisateur	/fr/docs/Archive/Web/XForms/Préférences_utilisateur
/fr/docs/XForms/Référence_API_XForms	/fr/docs/Archive/Web/XForms/Référence_API_XForms
/fr/docs/XForms/Résolution_des_problèmes_avec_XForms	/fr/docs/Archive/Web/XForms/Résolution_des_problèmes_avec_XForms
/fr/docs/XForms/Élément_interface_utilisateur_XForms	/fr/docs/Archive/Web/XForms/Élément_interface_utilisateur_XForms
/fr/docs/XForms:Autres_ressources	/fr/docs/Archive/Web/XForms/Autres_ressources
/fr/docs/XForms:Préférences_utilisateur	/fr/docs/Archive/Web/XForms/Préférences_utilisateur
/fr/docs/XPCOM/Reference/LandingPageListSubpages	/en-US/docs/Mozilla/Tech/XPCOM/Reference/Interface
/fr/docs/XPIDL	/fr/docs/Mozilla/Tech/XPIDL
/fr/docs/XPInstall	/fr/docs/Archive/Mozilla/XPInstall
/fr/docs/modifying_hosts_file	/fr/docs/Archive/B2G_OS/Tips_and_tricks/Modifier_le_fichier_hosts
/fr/docs/persona/Browser_compatibility	/fr/docs/Archive/Mozilla/Persona/Browser_compatibility
/fr/docs/persona/branding	/fr/docs/Archive/Mozilla/Persona/branding
/fr/docs/persona/promotion	/fr/docs/Archive/Mozilla/Persona/branding
