# FROM-URL	TO-URL
/es/docs/API_de_restauración_de_sesión	/es/docs/Archive/Add-ons/API_de_restauración_de_sesión
/es/docs/Analizar_microformatos_en_JavaScript	/es/docs/Archive/Estándares_Web/Analizar_microformatos_en_JavaScript
/es/docs/Aplicaciones/Enviar_una_aplicacion	/es/docs/Mozilla/Marketplace/Submission/Submitting_an_app
/es/docs/Aplicaciones/Packaged_apps	/es/docs/Mozilla/Marketplace/Publishing/Packaged_apps
/es/docs/Aplicaciones/Quickstart/Build	/es/docs/Archive/B2G_OS/Quickstart
/es/docs/Aplicaciones/Quickstart/Build/Introduccion_a_las_open_web_apps	/es/docs/Archive/B2G_OS/Quickstart/Introduccion_a_las_open_web_apps
/es/docs/Aplicaciones/Quickstart/Build/tu_primera_aplicacion	/es/docs/Archive/B2G_OS/Quickstart/tu_primera_aplicacion
/es/docs/Aplicaciones/Temas_avanzados	/es/docs/Archive/Apps/Advanced_topics
/es/docs/Bestiario_XUL	/es/docs/Archive/Mozilla/XUL/Bestiario_XUL
/es/docs/Componentes	/es/docs/Archive/Mozilla/XULRunner/Componentes
/es/docs/Crear_microformatos_en_JavaScript	/es/docs/Archive/Estándares_Web/Crear_microformatos_en_JavaScript
/es/docs/Cómo_implementar_un_componente_procesador_de_consultas_XUL	/es/docs/Archive/Mozilla/XUL/Cómo_implementar_un_componente_procesador_de_consultas_XUL
/es/docs/DOM/MozActivity	/es/docs/Archive/B2G_OS/API/MozActivity
/es/docs/El_administrador_de_hilos	/es/docs/Mozilla/XPCOM/XPCOM/El_administrador_de_hilos
/es/docs/El_uso_de_microformatos	/es/docs/Archive/Mozilla/Firefox/El_uso_de_microformatos
/es/docs/Escuela_XUL	/es/docs/Mozilla/Tech/XUL/Escuela_XUL
/es/docs/Escuela_XUL/Agregar_barras_de_herramientas_y_botones_para_éstas	/es/docs/Mozilla/Tech/XUL/Escuela_XUL/Agregar_barras_de_herramientas_y_botones_para_éstas
/es/docs/Escuela_XUL/Agregar_barras_laterales	/es/docs/Mozilla/Tech/XUL/Escuela_XUL/Agregar_barras_laterales
/es/docs/Escuela_XUL/Agregar_eventos_y_comandos	/es/docs/Mozilla/Tech/XUL/Escuela_XUL/Agregar_eventos_y_comandos
/es/docs/Escuela_XUL/Agregar_menus_y_submenus	/es/docs/Mozilla/Tech/XUL/Escuela_XUL/Agregar_menus_y_submenus
/es/docs/Escuela_XUL/Agregar_ventanas_y_dialogos	/es/docs/Mozilla/Tech/XUL/Escuela_XUL/Agregar_ventanas_y_dialogos
/es/docs/Escuela_XUL/Almacenamiento_local	/es/docs/Mozilla/Tech/XUL/Escuela_XUL/Almacenamiento_local
/es/docs/Escuela_XUL/Apéndice_A:_Rendimiento_de_los_Add-ons	/es/docs/Mozilla/Tech/XUL/Escuela_XUL/Apéndice_A:_Rendimiento_de_los_Add-ons
/es/docs/Escuela_XUL/Apéndice_B:_Instalar_y_desinstalar_Scripts	/es/docs/Mozilla/Tech/XUL/Escuela_XUL/Apéndice_B:_Instalar_y_desinstalar_Scripts
/es/docs/Escuela_XUL/Apéndice_C:_Evitar_usar_eval_en_los_Add-ons	/es/docs/Mozilla/Tech/XUL/Escuela_XUL/Apéndice_C:_Evitar_usar_eval_en_los_Add-ons
/es/docs/Escuela_XUL/Apéndice_D:_Cargar_Scripts	/es/docs/Mozilla/Tech/XUL/Escuela_XUL/Apéndice_D:_Cargar_Scripts
/es/docs/Escuela_XUL/Apéndice_E:_DOM_e_inserción_HTML	/es/docs/Mozilla/Tech/XUL/Escuela_XUL/Apéndice_E:_DOM_e_inserción_HTML
/es/docs/Escuela_XUL/Documentación_de_Mozilla	/es/docs/Mozilla/Tech/XUL/Escuela_XUL/Documentación_de_Mozilla
/es/docs/Escuela_XUL/El_modelo_de_caja	/es/docs/Archive/Mozilla/XUL/Tutorial_de_XUL/El_modelo_de_caja
/es/docs/Escuela_XUL/Elementos_esenciales_de_una_extensión	/es/docs/Mozilla/Tech/XUL/Escuela_XUL/Elementos_esenciales_de_una_extensión
/es/docs/Escuela_XUL/Enlazando_contenido_remoto	/es/docs/Mozilla/Tech/XUL/Escuela_XUL/Enlazando_contenido_remoto
/es/docs/Escuela_XUL/Introducción_a_las_extensiones_de_Firefox	/es/docs/Mozilla/Tech/XUL/Escuela_XUL/Introducción_a_las_extensiones_de_Firefox
/es/docs/Escuela_XUL/Introduction	/es/docs/Mozilla/Tech/XUL/Escuela_XUL/Introduction
/es/docs/Escuela_XUL/Manejo_de_preferencias	/es/docs/Mozilla/Tech/XUL/Escuela_XUL/Manejo_de_preferencias
/es/docs/Escuela_XUL/Montando_un_ambiente_de_desarrollo	/es/docs/Mozilla/Tech/XUL/Escuela_XUL/Montando_un_ambiente_de_desarrollo
/es/docs/Escuela_XUL/Notificaciones_Observer	/es/docs/Archive/Add-ons/Observer_Notifications
/es/docs/Escuela_XUL/Notificaciones_de_usuario_y_alertas	/es/docs/Mozilla/Tech/XUL/Escuela_XUL/Notificaciones_de_usuario_y_alertas
/es/docs/Escuela_XUL/Objetos_XPCOM	/es/docs/Mozilla/Tech/XUL/Escuela_XUL/Objetos_XPCOM
/es/docs/Escuela_XUL/Personalizar_elementos_XUL_con_XBL	/es/docs/Mozilla/Tech/XUL/Escuela_XUL/Personalizar_elementos_XUL_con_XBL
/es/docs/Escuela_XUL/Sitios_útiles_de_la_comunidad_Mozilla	/es/docs/Mozilla/Tech/XUL/Escuela_XUL/Sitios_útiles_de_la_comunidad_Mozilla
/es/docs/Escuela_XUL/Uso_de_objetos_en_JavaScript	/es/docs/Mozilla/Tech/XUL/Escuela_XUL/Uso_de_objetos_en_JavaScript
/es/docs/Estándares_Web	/es/docs/Archive/Estándares_Web
/es/docs/Extensiones	/es/docs/Extensions
/es/docs/Extensiones01	/es/docs/Extensions
/es/docs/Formato_para_la_versión_del_Toolkit	/es/docs/Mozilla/Toolkit_version_format
/es/docs/Guía_JavaScript_1.5/Concepto_General_de_LiveConnect/Conversiones_de_Tipo_de_Datos:	/en-US/docs/Archive/Web/LiveConnect/LiveConnect_Overview#Data_Type_Conversions
/es/docs/Guía_JavaScript_1.5/Concepto_general_de_LiveConnect	/es/docs/Archive/Web/LiveConnect
/es/docs/Guía_JavaScript_1.5/Concepto_general_de_LiveConnect/Comunicación_de_JavaScript_con_Java	/en-US/docs/Archive/Web/LiveConnect/LiveConnect_Overview
/es/docs/Guía_JavaScript_1.5/Concepto_general_de_LiveConnect/Comunicación_de_Java_con_JavaScript	/en-US/docs/Archive/Web/LiveConnect/LiveConnect_Overview
/es/docs/Guía_JavaScript_1.5/Concepto_general_de_LiveConnect/Comunicación_de_Java_con_JavaScript/Utilizar_las_clases_de_LiveConnect	/en-US/docs/Archive/Web/LiveConnect/LiveConnect_Overview
/es/docs/Guía_JavaScript_1.5/Concepto_general_de_LiveConnect/Conversiones_de_tipos_de_datos	/en-US/docs/Archive/Web/LiveConnect/LiveConnect_Overview#Data_Type_Conversions
/es/docs/Guía_JavaScript_1.5/Concepto_general_de_LiveConnect/Conversiones_de_tipos_de_datos/Conversiones_de_JavaScript_a_Java	/en-US/docs/Archive/Web/LiveConnect/LiveConnect_Overview#JavaScript_to_Java_Conversions
/es/docs/Guía_JavaScript_1.5/Concepto_general_de_LiveConnect/Conversiones_de_tipos_de_datos/Conversiones_de_Java_a_JavaScript	/en-US/docs/Archive/Web/LiveConnect/LiveConnect_Overview#Java_to_JavaScript_Conversions
/es/docs/Guía_JavaScript_1.5/Concepto_general_de_LiveConnect/Trabajando_con_envoltorios	/en-US/docs/Archive/Web/LiveConnect/LiveConnect_Overview#Working_with_Wrappers
/es/docs/Guía_JavaScript_1.5:Concepto_General_de_LiveConnect:Conversiones_de_Tipo_de_Datos:	/en-US/docs/Archive/Web/LiveConnect/LiveConnect_Overview#Data_Type_Conversions
/es/docs/Guía_JavaScript_1.5:Concepto_General_de_LiveConnect:Conversiones_de_tipos_de_datos:Conversiones_de_Java_a_JavaScript	/en-US/docs/Archive/Web/LiveConnect/LiveConnect_Overview#Java_to_JavaScript_Conversions
/es/docs/Guía_JavaScript_1.5:Concepto_general_de_LiveConnect	/es/docs/Archive/Web/LiveConnect
/es/docs/Guía_JavaScript_1.5:Concepto_general_de_LiveConnect:Comunicación_de_JavaScript_con_Java	/en-US/docs/Archive/Web/LiveConnect/LiveConnect_Overview
/es/docs/Guía_JavaScript_1.5:Concepto_general_de_LiveConnect:Comunicación_de_Java_con_JavaScript	/en-US/docs/Archive/Web/LiveConnect/LiveConnect_Overview
/es/docs/Guía_JavaScript_1.5:Concepto_general_de_LiveConnect:Comunicación_de_Java_con_JavaScript:Utilizar_las_clases_de_LiveConnect	/en-US/docs/Archive/Web/LiveConnect/LiveConnect_Overview
/es/docs/Guía_JavaScript_1.5:Concepto_general_de_LiveConnect:Conversiones_de_tipos_de_datos	/en-US/docs/Archive/Web/LiveConnect/LiveConnect_Overview#Data_Type_Conversions
/es/docs/Guía_JavaScript_1.5:Concepto_general_de_LiveConnect:Conversiones_de_tipos_de_datos:Conversiones_de_JavaScript_a_Java	/en-US/docs/Archive/Web/LiveConnect/LiveConnect_Overview#JavaScript_to_Java_Conversions
/es/docs/Guía_JavaScript_1.5:Concepto_general_de_LiveConnect:Trabajando_con_envoltorios	/en-US/docs/Archive/Web/LiveConnect/LiveConnect_Overview#Working_with_Wrappers
/es/docs/Herencia_de_atributos_xbl_en_Firefox_1.5_y_2.0.	/es/docs/Archive/Mozilla/XUL/Tutorial_de_XUL/Herencia_de_atributos_xbl_en_Firefox_1.5_y_2.0.
/es/docs/Imágenes,_tablas_y_huecos_misteriosos	/es/docs/Archive/Misc_top_level/Imágenes,_tablas_y_huecos_misteriosos
/es/docs/Introducción	/es/docs/Archive/Mozilla/XUL/Tutorial_de_XUL/Introducción
/es/docs/JavaScript/Guide/Obsolete_Pages/Guía_JavaScript_1.5/Comunicación_de_Java_con_JavaScript	/en-US/docs/Archive/Web/LiveConnect/LiveConnect_Overview
/es/docs/JavaScript/Guide/Obsolete_Pages/Guía_JavaScript_1.5/Comunicación_de_Java_con_JavaScript/Utilizar_las_clases_de_LiveConnect	/en-US/docs/Archive/Web/LiveConnect/LiveConnect_Overview
/es/docs/JavaScript/Guide/Obsolete_Pages/Guía_JavaScript_1.5/Concepto_general_de_LiveConnect	/es/docs/Archive/Web/LiveConnect
/es/docs/JavaScript/Guide/Obsolete_Pages/Guía_JavaScript_1.5/Concepto_general_de_LiveConnect/Comunicación_de_JavaScript_con_Java	/en-US/docs/Archive/Web/LiveConnect/LiveConnect_Overview
/es/docs/JavaScript/Guide/Obsolete_Pages/Guía_JavaScript_1.5/Concepto_general_de_LiveConnect/Conversiones_de_Tipo_de_Datos:	/en-US/docs/Archive/Web/LiveConnect/LiveConnect_Overview#Data_Type_Conversions
/es/docs/JavaScript/Guide/Obsolete_Pages/Guía_JavaScript_1.5/Conversiones_de_tipos_de_datos	/en-US/docs/Archive/Web/LiveConnect/LiveConnect_Overview#Data_Type_Conversions
/es/docs/JavaScript/Guide/Obsolete_Pages/Guía_JavaScript_1.5/Conversiones_de_tipos_de_datos/Conversiones_de_JavaScript_a_Java	/en-US/docs/Archive/Web/LiveConnect/LiveConnect_Overview#JavaScript_to_Java_Conversions
/es/docs/JavaScript/Guide/Obsolete_Pages/Guía_JavaScript_1.5/Conversiones_de_tipos_de_datos/Conversiones_de_Java_a_JavaScript	/en-US/docs/Archive/Web/LiveConnect/LiveConnect_Overview#Java_to_JavaScript_Conversions
/es/docs/JavaScript/Guide/Obsolete_Pages/Guía_JavaScript_1.5/Trabajando_con_envoltorios	/en-US/docs/Archive/Web/LiveConnect/LiveConnect_Overview#Working_with_Wrappers
/es/docs/JavaScript/Referencia/LiveConnect	/es/docs/Archive/Web/LiveConnect
/es/docs/JavaScript/Referencia/Objetos_globales/JavaArray	/es/docs/Archive/Web/LiveConnect/JavaArray
/es/docs/JavaScript/Referencia/Objetos_globales/JavaClass	/es/docs/Archive/Web/LiveConnect/JavaClass
/es/docs/JavaScript/Referencia/Objetos_globales/JavaObject	/es/docs/Archive/Web/LiveConnect/JavaObject
/es/docs/JavaScript/Referencia/Objetos_globales/JavaPackage	/es/docs/Archive/Web/LiveConnect/JavaPackage
/es/docs/JavaScript/Referencia/Objetos_globales/Packages	/es/docs/Archive/Web/LiveConnect/Packages
/es/docs/JavaScript/Referencia/Objetos_globales/java	/es/docs/Archive/Web/LiveConnect/java
/es/docs/JavaScript/Referencia/Objetos_globales/netscape	/es/docs/Archive/Web/LiveConnect/netscape
/es/docs/JavaScript/Referencia/Objetos_globales/sun	/es/docs/Archive/Web/LiveConnect/sun
/es/docs/Participating_in_the_Mozilla_project	/es/docs/Mozilla/Participating_in_the_Mozilla_project
/es/docs/Permitir_sugerencias_en_los_plugins_de_búsqueda	/es/docs/Archive/Add-ons/Permitir_sugerencias_en_los_plugins_de_búsqueda
/es/docs/Preguntas_frecuentes_sobre_RDF_en_Mozilla	/es/docs/Archive/Estándares_Web/Preguntas_frecuentes_sobre_RDF_en_Mozilla
/es/docs/Primeros_pasos_con_XULRunner	/es/docs/Archive/Mozilla/XULRunner/Primeros_pasos_con_XULRunner
/es/docs/RSS	/es/docs/Archive/RSS
/es/docs/RSS/Primeros_pasos	/es/docs/Archive/RSS/Primeros_pasos
/es/docs/RSS/Versiones	/es/docs/Archive/RSS/Versiones
/es/docs/RSS:Primeros_pasos	/es/docs/Archive/RSS/Primeros_pasos
/es/docs/RSS:Versiones	/es/docs/Archive/RSS/Versiones
/es/docs/Referencia_de_JavaScript_1.5/LiveConnect	/es/docs/Archive/Web/LiveConnect
/es/docs/Referencia_de_JavaScript_1.5/Objetos_globales/JavaArray	/es/docs/Archive/Web/LiveConnect/JavaArray
/es/docs/Referencia_de_JavaScript_1.5/Objetos_globales/JavaClass	/es/docs/Archive/Web/LiveConnect/JavaClass
/es/docs/Referencia_de_JavaScript_1.5/Objetos_globales/JavaObject	/es/docs/Archive/Web/LiveConnect/JavaObject
/es/docs/Referencia_de_JavaScript_1.5/Objetos_globales/JavaPackage	/es/docs/Archive/Web/LiveConnect/JavaPackage
/es/docs/Referencia_de_JavaScript_1.5/Objetos_globales/Packages	/es/docs/Archive/Web/LiveConnect/Packages
/es/docs/Referencia_de_JavaScript_1.5/Objetos_globales/java	/es/docs/Archive/Web/LiveConnect/java
/es/docs/Referencia_de_JavaScript_1.5/Objetos_globales/netscape	/es/docs/Archive/Web/LiveConnect/netscape
/es/docs/Referencia_de_JavaScript_1.5/Objetos_globales/sun	/es/docs/Archive/Web/LiveConnect/sun
/es/docs/Referencia_de_JavaScript_1.5:LiveConnect	/es/docs/Archive/Web/LiveConnect
/es/docs/Referencia_de_JavaScript_1.5:Objetos_globales:JavaArray	/es/docs/Archive/Web/LiveConnect/JavaArray
/es/docs/Referencia_de_JavaScript_1.5:Objetos_globales:JavaClass	/es/docs/Archive/Web/LiveConnect/JavaClass
/es/docs/Referencia_de_JavaScript_1.5:Objetos_globales:JavaObject	/es/docs/Archive/Web/LiveConnect/JavaObject
/es/docs/Referencia_de_JavaScript_1.5:Objetos_globales:JavaPackage	/es/docs/Archive/Web/LiveConnect/JavaPackage
/es/docs/Referencia_de_JavaScript_1.5:Objetos_globales:Packages	/es/docs/Archive/Web/LiveConnect/Packages
/es/docs/Referencia_de_JavaScript_1.5:Objetos_globales:java	/es/docs/Archive/Web/LiveConnect/java
/es/docs/Referencia_de_JavaScript_1.5:Objetos_globales:netscape	/es/docs/Archive/Web/LiveConnect/netscape
/es/docs/Referencia_de_JavaScript_1.5:Objetos_globales:sun	/es/docs/Archive/Web/LiveConnect/sun
/es/docs/SOAP_en_los_navegadores_basados_en_Gecko	/es/docs/Archive/Mozilla/Firefox/SOAP_en_los_navegadores_basados_en_Gecko
/es/docs/Temas/Crea_tu_propio_Tema_de_Fondo_para_Firefox	/es/docs/Archive/Themes/Create_Your_Own_Firefox_Background_Theme
/es/docs/Tinderbox	/es/docs/Archive/Mozilla/Tinderbox
/es/docs/Toolkit_version_format	/es/docs/Mozilla/Toolkit_version_format
/es/docs/Tools/Simulador_Firefox_OS	/es/docs/Archive/B2G_OS/Simulator
/es/docs/Trabajar_con_ventanas_desde_código_chrome	/es/docs/Mozilla/Working_with_windows_in_chrome_code
/es/docs/Tutorial_de_XUL	/es/docs/Archive/Mozilla/XUL/Tutorial_de_XUL
/es/docs/Tutorial_de_XUL/Actualizar_comandos	/es/docs/Archive/Mozilla/XUL/Tutorial_de_XUL/Actualizar_comandos
/es/docs/Tutorial_de_XUL/Archivos_Manifest	/es/docs/Archive/Mozilla/XUL/Tutorial_de_XUL/Archivos_Manifest
/es/docs/Tutorial_de_XUL/Atajos_de_teclado	/es/docs/Archive/Mozilla/XUL/Tutorial_de_XUL/Atajos_de_teclado
/es/docs/Tutorial_de_XUL/Añadiendo_botones	/es/docs/Archive/Mozilla/XUL/Tutorial_de_XUL/Añadiendo_botones
/es/docs/Tutorial_de_XUL/Añadiendo_elementos_HTML	/es/docs/Archive/Mozilla/XUL/Tutorial_de_XUL/Añadiendo_elementos_HTML
/es/docs/Tutorial_de_XUL/Añadiendo_etiquetas_e_imagenes	/es/docs/Archive/Mozilla/XUL/Tutorial_de_XUL/Añadiendo_etiquetas_e_imagenes
/es/docs/Tutorial_de_XUL/Añadiendo_los_gestores_de_eventos	/es/docs/Archive/Mozilla/XUL/Tutorial_de_XUL/Añadiendo_los_gestores_de_eventos
/es/docs/Tutorial_de_XUL/Añadiendo_más_elementos	/es/docs/Archive/Mozilla/XUL/Tutorial_de_XUL/Añadiendo_más_elementos
/es/docs/Tutorial_de_XUL/Barra_de_Herramientas	/es/docs/Archive/Mozilla/XUL/Tutorial_de_XUL/Barra_de_Herramientas
/es/docs/Tutorial_de_XUL/Barras_de_desplazamiento	/es/docs/Archive/Mozilla/XUL/Tutorial_de_XUL/Barras_de_desplazamiento
/es/docs/Tutorial_de_XUL/Cajas_de_grupo	/es/docs/Archive/Mozilla/XUL/Tutorial_de_XUL/Cajas_de_grupo
/es/docs/Tutorial_de_XUL/Características_adicionales_de_la_instalación	/es/docs/Archive/Mozilla/XUL/Tutorial_de_XUL/Características_adicionales_de_la_instalación
/es/docs/Tutorial_de_XUL/Características_de_una_ventana	/es/docs/Archive/Mozilla/XUL/Tutorial_de_XUL/Características_de_una_ventana
/es/docs/Tutorial_de_XUL/Comandos	/es/docs/Archive/Mozilla/XUL/Tutorial_de_XUL/Comandos
/es/docs/Tutorial_de_XUL/Controles_de_entrada	/es/docs/Archive/Mozilla/XUL/Tutorial_de_XUL/Controles_de_entrada
/es/docs/Tutorial_de_XUL/Controles_de_listas	/es/docs/Archive/Mozilla/XUL/Tutorial_de_XUL/Controles_de_listas
/es/docs/Tutorial_de_XUL/Creando_un_asistente	/es/docs/Archive/Mozilla/XUL/Tutorial_de_XUL/Creando_un_asistente
/es/docs/Tutorial_de_XUL/Creando_un_instalador	/es/docs/Archive/Mozilla/XUL/Tutorial_de_XUL/Creando_un_instalador
/es/docs/Tutorial_de_XUL/Creando_una_ventana	/es/docs/Archive/Mozilla/XUL/Tutorial_de_XUL/Creando_una_ventana
/es/docs/Tutorial_de_XUL/Detalles_de_Vistas_de_un_árbol	/es/docs/Archive/Mozilla/XUL/Tutorial_de_XUL/Detalles_de_Vistas_de_un_árbol
/es/docs/Tutorial_de_XUL/Detalles_del_modelo_de_caja	/es/docs/Archive/Mozilla/XUL/Tutorial_de_XUL/Detalles_del_modelo_de_caja
/es/docs/Tutorial_de_XUL/Divisores	/es/docs/Archive/Mozilla/XUL/Tutorial_de_XUL/Divisores
/es/docs/Tutorial_de_XUL/Diálogos_Abrir_y_Guardar	/es/docs/Archive/Mozilla/XUL/Tutorial_de_XUL/Diálogos_Abrir_y_Guardar
/es/docs/Tutorial_de_XUL/Emisores_y_receptores	/es/docs/Archive/Mozilla/XUL/Tutorial_de_XUL/Emisores_y_receptores
/es/docs/Tutorial_de_XUL/Estructura_XUL	/es/docs/Archive/Mozilla/XUL/Tutorial_de_XUL/Estructura_XUL
/es/docs/Tutorial_de_XUL/Foco_y_Selección	/es/docs/Archive/Mozilla/XUL/Tutorial_de_XUL/Foco_y_Selección
/es/docs/Tutorial_de_XUL/Grillas	/es/docs/Archive/Mozilla/XUL/Tutorial_de_XUL/Rejillas
/es/docs/Tutorial_de_XUL/Instalando_Scripts	/es/docs/Archive/Mozilla/XUL/Tutorial_de_XUL/Instalando_Scripts
/es/docs/Tutorial_de_XUL/Interfaces_XPCOM	/es/docs/Archive/Mozilla/XUL/Tutorial_de_XUL/Interfaces_XPCOM
/es/docs/Tutorial_de_XUL/Introducción	/es/docs/Archive/Mozilla/XUL/Tutorial_de_XUL/Introducción
/es/docs/Tutorial_de_XUL/Introducción_a_RDF	/es/docs/Archive/Mozilla/XUL/Tutorial_de_XUL/Introducción_a_RDF
/es/docs/Tutorial_de_XUL/La_URL_chrome	/es/docs/Archive/Mozilla/XUL/Tutorial_de_XUL/La_URL_chrome
/es/docs/Tutorial_de_XUL/Manipulando_listas	/es/docs/Archive/Mozilla/XUL/Tutorial_de_XUL/Manipulando_listas
/es/docs/Tutorial_de_XUL/Medidores_de_Progreso	/es/docs/Archive/Mozilla/XUL/Tutorial_de_XUL/Medidores_de_Progreso
/es/docs/Tutorial_de_XUL/Menúes_con_desplazamiento	/es/docs/Archive/Mozilla/XUL/Tutorial_de_XUL/Menús_con_desplazamiento
/es/docs/Tutorial_de_XUL/Menúes_de_Barras_Simples	/es/docs/Archive/Mozilla/XUL/Tutorial_de_XUL/Menús_de_Barras_Simples
/es/docs/Tutorial_de_XUL/Menúes_emergentes	/es/docs/Archive/Mozilla/XUL/Tutorial_de_XUL/Menús_emergentes
/es/docs/Tutorial_de_XUL/Menús_con_desplazamiento	/es/docs/Archive/Mozilla/XUL/Tutorial_de_XUL/Menús_con_desplazamiento
/es/docs/Tutorial_de_XUL/Menús_de_Barras_Simples	/es/docs/Archive/Mozilla/XUL/Tutorial_de_XUL/Menús_de_Barras_Simples
/es/docs/Tutorial_de_XUL/Menús_emergentes	/es/docs/Archive/Mozilla/XUL/Tutorial_de_XUL/Menús_emergentes
/es/docs/Tutorial_de_XUL/Modelo_de_objeto_de_documento	/es/docs/Archive/Mozilla/XUL/Tutorial_de_XUL/Modelo_de_objeto_de_documento
/es/docs/Tutorial_de_XUL/Modificando_una_interfaz_XUL	/es/docs/Archive/Mozilla/XUL/Tutorial_de_XUL/Modificando_una_interfaz_XUL
/es/docs/Tutorial_de_XUL/Más_asistentes	/es/docs/Archive/Mozilla/XUL/Tutorial_de_XUL/Más_asistentes
/es/docs/Tutorial_de_XUL/Más_características_de_los_botones	/es/docs/Archive/Mozilla/XUL/Tutorial_de_XUL/Más_características_de_los_botones
/es/docs/Tutorial_de_XUL/Más_características_de_los_árboles	/es/docs/Archive/Mozilla/XUL/Tutorial_de_XUL/Más_características_de_los_árboles
/es/docs/Tutorial_de_XUL/Más_funciones_de_menú	/es/docs/Archive/Mozilla/XUL/Tutorial_de_XUL/Más_funciones_de_menú
/es/docs/Tutorial_de_XUL/Más_gestores_de_eventos	/es/docs/Archive/Mozilla/XUL/Tutorial_de_XUL/Más_gestores_de_eventos
/es/docs/Tutorial_de_XUL/Objeto_de_caja_de_árbol	/es/docs/Archive/Mozilla/XUL/Tutorial_de_XUL/Objeto_de_caja_de_árbol
/es/docs/Tutorial_de_XUL/Paneles_de_contenidos	/es/docs/Archive/Mozilla/XUL/Tutorial_de_XUL/Paneles_de_contenidos
/es/docs/Tutorial_de_XUL/Plantillas	/es/docs/Archive/Mozilla/XUL/Tutorial_de_XUL/Plantillas
/es/docs/Tutorial_de_XUL/Posicionamiento_de_elementos_de_la_ventana	/es/docs/Archive/Mozilla/XUL/Tutorial_de_XUL/Posicionamiento_de_elementos_de_la_ventana
/es/docs/Tutorial_de_XUL/Rejillas	/es/docs/Archive/Mozilla/XUL/Tutorial_de_XUL/Rejillas
/es/docs/Tutorial_de_XUL/Selección_en_un_árbol	/es/docs/Archive/Mozilla/XUL/Tutorial_de_XUL/Selección_en_un_árbol
/es/docs/Tutorial_de_XUL/Usando_espaciadores	/es/docs/Archive/Mozilla/XUL/Tutorial_de_XUL/Usando_espaciadores
/es/docs/Tutorial_de_XUL/Árboles	/es/docs/Archive/Mozilla/XUL/Tutorial_de_XUL/Árboles
/es/docs/Tutorial_de_XUL/Árboles_y_plantillas	/es/docs/Archive/Mozilla/XUL/Tutorial_de_XUL/Árboles_y_plantillas
/es/docs/Tutorial_de_XUL:Actualizar_comandos	/es/docs/Archive/Mozilla/XUL/Tutorial_de_XUL/Actualizar_comandos
/es/docs/Tutorial_de_XUL:Archivos_Manifest	/es/docs/Archive/Mozilla/XUL/Tutorial_de_XUL/Archivos_Manifest
/es/docs/Tutorial_de_XUL:Atajos_de_teclado	/es/docs/Archive/Mozilla/XUL/Tutorial_de_XUL/Atajos_de_teclado
/es/docs/Tutorial_de_XUL:Añadiendo_botones	/es/docs/Archive/Mozilla/XUL/Tutorial_de_XUL/Añadiendo_botones
/es/docs/Tutorial_de_XUL:Añadiendo_elementos_HTML	/es/docs/Archive/Mozilla/XUL/Tutorial_de_XUL/Añadiendo_elementos_HTML
/es/docs/Tutorial_de_XUL:Añadiendo_etiquetas_e_imagenes	/es/docs/Archive/Mozilla/XUL/Tutorial_de_XUL/Añadiendo_etiquetas_e_imagenes
/es/docs/Tutorial_de_XUL:Añadiendo_los_gestores_de_eventos	/es/docs/Archive/Mozilla/XUL/Tutorial_de_XUL/Añadiendo_los_gestores_de_eventos
/es/docs/Tutorial_de_XUL:Añadiendo_más_elementos	/es/docs/Archive/Mozilla/XUL/Tutorial_de_XUL/Añadiendo_más_elementos
/es/docs/Tutorial_de_XUL:Barra_de_Herramientas	/es/docs/Archive/Mozilla/XUL/Tutorial_de_XUL/Barra_de_Herramientas
/es/docs/Tutorial_de_XUL:Barras_de_desplazamiento	/es/docs/Archive/Mozilla/XUL/Tutorial_de_XUL/Barras_de_desplazamiento
/es/docs/Tutorial_de_XUL:Cajas_de_grupo	/es/docs/Archive/Mozilla/XUL/Tutorial_de_XUL/Cajas_de_grupo
/es/docs/Tutorial_de_XUL:Características_adicionales_de_la_instalación	/es/docs/Archive/Mozilla/XUL/Tutorial_de_XUL/Características_adicionales_de_la_instalación
/es/docs/Tutorial_de_XUL:Características_de_una_ventana	/es/docs/Archive/Mozilla/XUL/Tutorial_de_XUL/Características_de_una_ventana
/es/docs/Tutorial_de_XUL:Comandos	/es/docs/Archive/Mozilla/XUL/Tutorial_de_XUL/Comandos
/es/docs/Tutorial_de_XUL:Controles_de_entrada	/es/docs/Archive/Mozilla/XUL/Tutorial_de_XUL/Controles_de_entrada
/es/docs/Tutorial_de_XUL:Controles_de_listas	/es/docs/Archive/Mozilla/XUL/Tutorial_de_XUL/Controles_de_listas
/es/docs/Tutorial_de_XUL:Creando_un_asistente	/es/docs/Archive/Mozilla/XUL/Tutorial_de_XUL/Creando_un_asistente
/es/docs/Tutorial_de_XUL:Creando_un_instalador	/es/docs/Archive/Mozilla/XUL/Tutorial_de_XUL/Creando_un_instalador
/es/docs/Tutorial_de_XUL:Creando_una_ventana	/es/docs/Archive/Mozilla/XUL/Tutorial_de_XUL/Creando_una_ventana
/es/docs/Tutorial_de_XUL:Detalles_de_Vistas_de_un_árbol	/es/docs/Archive/Mozilla/XUL/Tutorial_de_XUL/Detalles_de_Vistas_de_un_árbol
/es/docs/Tutorial_de_XUL:Detalles_del_modelo_de_caja	/es/docs/Archive/Mozilla/XUL/Tutorial_de_XUL/Detalles_del_modelo_de_caja
/es/docs/Tutorial_de_XUL:Divisores	/es/docs/Archive/Mozilla/XUL/Tutorial_de_XUL/Divisores
/es/docs/Tutorial_de_XUL:Diálogos_Abrir_y_Guardar	/es/docs/Archive/Mozilla/XUL/Tutorial_de_XUL/Diálogos_Abrir_y_Guardar
/es/docs/Tutorial_de_XUL:Emisores_y_receptores	/es/docs/Archive/Mozilla/XUL/Tutorial_de_XUL/Emisores_y_receptores
/es/docs/Tutorial_de_XUL:Estructura_XUL	/es/docs/Archive/Mozilla/XUL/Tutorial_de_XUL/Estructura_XUL
/es/docs/Tutorial_de_XUL:Foco_y_Selección	/es/docs/Archive/Mozilla/XUL/Tutorial_de_XUL/Foco_y_Selección
/es/docs/Tutorial_de_XUL:Grillas	/es/docs/Archive/Mozilla/XUL/Tutorial_de_XUL/Rejillas
/es/docs/Tutorial_de_XUL:Instalando_Scripts	/es/docs/Archive/Mozilla/XUL/Tutorial_de_XUL/Instalando_Scripts
/es/docs/Tutorial_de_XUL:Interfaces_XPCOM	/es/docs/Archive/Mozilla/XUL/Tutorial_de_XUL/Interfaces_XPCOM
/es/docs/Tutorial_de_XUL:Introducción	/es/docs/Archive/Mozilla/XUL/Tutorial_de_XUL/Introducción
/es/docs/Tutorial_de_XUL:Introducción_a_RDF	/es/docs/Archive/Mozilla/XUL/Tutorial_de_XUL/Introducción_a_RDF
/es/docs/Tutorial_de_XUL:La_URL_chrome	/es/docs/Archive/Mozilla/XUL/Tutorial_de_XUL/La_URL_chrome
/es/docs/Tutorial_de_XUL:Manipulando_listas	/es/docs/Archive/Mozilla/XUL/Tutorial_de_XUL/Manipulando_listas
/es/docs/Tutorial_de_XUL:Medidores_de_progreso	/es/docs/Archive/Mozilla/XUL/Tutorial_de_XUL/Medidores_de_Progreso
/es/docs/Tutorial_de_XUL:Menúes_con_desplazamiento	/es/docs/Archive/Mozilla/XUL/Tutorial_de_XUL/Menús_con_desplazamiento
/es/docs/Tutorial_de_XUL:Menúes_de_Barras_Simples	/es/docs/Archive/Mozilla/XUL/Tutorial_de_XUL/Menús_de_Barras_Simples
/es/docs/Tutorial_de_XUL:Menúes_emergentes	/es/docs/Archive/Mozilla/XUL/Tutorial_de_XUL/Menús_emergentes
/es/docs/Tutorial_de_XUL:Modelo_de_objeto_de_documento	/es/docs/Archive/Mozilla/XUL/Tutorial_de_XUL/Modelo_de_objeto_de_documento
/es/docs/Tutorial_de_XUL:Modificando_una_interfaz_XUL	/es/docs/Archive/Mozilla/XUL/Tutorial_de_XUL/Modificando_una_interfaz_XUL
/es/docs/Tutorial_de_XUL:Más_asistentes	/es/docs/Archive/Mozilla/XUL/Tutorial_de_XUL/Más_asistentes
/es/docs/Tutorial_de_XUL:Más_características_de_los_botones	/es/docs/Archive/Mozilla/XUL/Tutorial_de_XUL/Más_características_de_los_botones
/es/docs/Tutorial_de_XUL:Más_características_de_los_árboles	/es/docs/Archive/Mozilla/XUL/Tutorial_de_XUL/Más_características_de_los_árboles
/es/docs/Tutorial_de_XUL:Más_funciones_de_menú	/es/docs/Archive/Mozilla/XUL/Tutorial_de_XUL/Más_funciones_de_menú
/es/docs/Tutorial_de_XUL:Más_gestores_de_eventos	/es/docs/Archive/Mozilla/XUL/Tutorial_de_XUL/Más_gestores_de_eventos
/es/docs/Tutorial_de_XUL:Objeto_de_caja_de_árbol	/es/docs/Archive/Mozilla/XUL/Tutorial_de_XUL/Objeto_de_caja_de_árbol
/es/docs/Tutorial_de_XUL:Paneles_de_contenidos	/es/docs/Archive/Mozilla/XUL/Tutorial_de_XUL/Paneles_de_contenidos
/es/docs/Tutorial_de_XUL:Plantillas	/es/docs/Archive/Mozilla/XUL/Tutorial_de_XUL/Plantillas
/es/docs/Tutorial_de_XUL:Posicionamiento_de_elementos_de_la_ventana	/es/docs/Archive/Mozilla/XUL/Tutorial_de_XUL/Posicionamiento_de_elementos_de_la_ventana
/es/docs/Tutorial_de_XUL:Rejillas	/es/docs/Archive/Mozilla/XUL/Tutorial_de_XUL/Rejillas
/es/docs/Tutorial_de_XUL:Selección_en_un_árbol	/es/docs/Archive/Mozilla/XUL/Tutorial_de_XUL/Selección_en_un_árbol
/es/docs/Tutorial_de_XUL:Usando_espaciadores	/es/docs/Archive/Mozilla/XUL/Tutorial_de_XUL/Usando_espaciadores
/es/docs/Tutorial_de_XUL:Árboles	/es/docs/Archive/Mozilla/XUL/Tutorial_de_XUL/Árboles
/es/docs/Tutorial_de_XUL:Árboles_y_plantillas	/es/docs/Archive/Mozilla/XUL/Tutorial_de_XUL/Árboles_y_plantillas
/es/docs/Usando_el_marcado_correcto_para_llamar_a_los_plugins	/es/docs/Archive/Estándares_Web/Usando_el_marcado_correcto_para_llamar_a_los_plugins
/es/docs/Usar_las_preferencias_de_contenido	/es/docs/Archive/Misc_top_level/Usar_las_preferencias_de_contenido
/es/docs/Usas_las_preferencias_de_contenido	/es/docs/Archive/Misc_top_level/Usar_las_preferencias_de_contenido
/es/docs/Ventajas_para_los_negocios_del_uso_de_estándares_web	/es/docs/Archive/Estándares_Web/Ventajas_para_los_negocios_del_uso_de_estándares_web
/es/docs/Versionado,_actualización_y_compatibilidad_de_extensiones	/es/docs/Archive/Add-ons/Versionado,_actualización_y_compatibilidad_de_extensiones
/es/docs/Web/API/CallEvent	/es/docs/Archive/B2G_OS/API/CallEvent
/es/docs/Web/API/MozActivity	/es/docs/Archive/B2G_OS/API/MozActivity
/es/docs/Web/API/Navigator.mozTelephony	/es/docs/Archive/B2G_OS/API/Navigator/MozTelephony
/es/docs/Web/API/Navigator/mozAlarms	/es/docs/Archive/B2G_OS/API/Navigator/mozAlarms
/es/docs/Web/API/Navigator/mozApps	/es/docs/Archive/B2G_OS/API/Navigator/mozApps
/es/docs/Web/API/Navigator/mozNotification	/es/docs/Archive/API/Navigator/mozNotification
/es/docs/Web/API/Navigator/mozTelephony	/es/docs/Archive/B2G_OS/API/Navigator/MozTelephony
/es/docs/Web/API/Telephony	/es/docs/Archive/B2G_OS/API/Telephony
/es/docs/Web/API/TelephonyCall	/es/docs/Archive/B2G_OS/API/TelephonyCall
/es/docs/Web/API/TelephonyCall.hangUp	/es/docs/Archive/B2G_OS/API/TelephonyCall/hangUp
/es/docs/Web/API/TelephonyCall.number	/es/docs/Archive/B2G_OS/API/TelephonyCall/number
/es/docs/Web/API/TelephonyCall.onincoming	/es/docs/Archive/B2G_OS/API/TelephonyCall/onincoming
/es/docs/Web/API/TelephonyCall/hangUp	/es/docs/Archive/B2G_OS/API/TelephonyCall/hangUp
/es/docs/Web/API/TelephonyCall/number	/es/docs/Archive/B2G_OS/API/TelephonyCall/number
/es/docs/Web/API/TelephonyCall/onincoming	/es/docs/Archive/B2G_OS/API/TelephonyCall/onincoming
/es/docs/Web/API/navigator.mozNotification	/es/docs/Archive/API/Navigator/mozNotification
/es/docs/Web/API/window.navigator.mozAlarms	/es/docs/Archive/B2G_OS/API/Navigator/mozAlarms
/es/docs/Web/Aplicaciones/Quickstart/Build	/es/docs/Archive/B2G_OS/Quickstart
/es/docs/Web/Aplicaciones/Quickstart/Build/App_tools	/es/docs/Archive/B2G_OS/Quickstart/App_tools
/es/docs/Web/Aplicaciones/Quickstart/Build/Intro_to_manifests	/es/docs/Archive/B2G_OS/Quickstart/Intro_to_manifests
/es/docs/Web/Aplicaciones/Quickstart/Build/Introduccion_a_las_open_web_apps	/es/docs/Archive/B2G_OS/Quickstart/Introduccion_a_las_open_web_apps
/es/docs/Web/Aplicaciones/Quickstart/Build/tu_primera_aplicacion	/es/docs/Archive/B2G_OS/Quickstart/tu_primera_aplicacion
/es/docs/Web/Aplicaciones/Temas_avanzados	/es/docs/Archive/Apps/Advanced_topics
/es/docs/Web/Apps/Developing/Packaged_apps/Packaged_apps	/es/docs/Mozilla/Marketplace/Publishing/Packaged_apps
/es/docs/Web/Apps/Developing/Updating_apps	/es/docs/Mozilla/Marketplace/Publishing/Updating_apps
/es/docs/Web/Apps/Quickstart/Build	/es/docs/Archive/B2G_OS/Quickstart
/es/docs/Web/Apps/Quickstart/Build/Introduccion_a_las_open_web_apps	/es/docs/Archive/B2G_OS/Quickstart/Introduccion_a_las_open_web_apps
/es/docs/Web/Apps/Quickstart/Build/tu_primera_aplicacion	/es/docs/Archive/B2G_OS/Quickstart/tu_primera_aplicacion
/es/docs/Web/CSS/CSS3	/es/docs/Archive/CSS3
/es/docs/Web/Guide/API/Telephony	/es/docs/Archive/B2G_OS/Web_Telephony_API
/es/docs/Web/Guide/API/Telephony/Introduccion_a_la_WebTelephony	/es/docs/Archive/B2G_OS/Web_Telephony_API/Introduccion_a_la_WebTelephony
/es/docs/Web/JavaScript/Guide/Obsolete_Pages/Guía_JavaScript_1.5/Comunicación_de_Java_con_JavaScript	/en-US/docs/Archive/Web/LiveConnect/LiveConnect_Overview
/es/docs/Web/JavaScript/Guide/Obsolete_Pages/Guía_JavaScript_1.5/Comunicación_de_Java_con_JavaScript/Utilizar_las_clases_de_LiveConnect	/en-US/docs/Archive/Web/LiveConnect/LiveConnect_Overview
/es/docs/Web/JavaScript/Guide/Obsolete_Pages/Guía_JavaScript_1.5/Concepto_general_de_LiveConnect	/es/docs/Archive/Web/LiveConnect
/es/docs/Web/JavaScript/Guide/Obsolete_Pages/Guía_JavaScript_1.5/Concepto_general_de_LiveConnect/Comunicación_de_JavaScript_con_Java	/en-US/docs/Archive/Web/LiveConnect/LiveConnect_Overview
/es/docs/Web/JavaScript/Guide/Obsolete_Pages/Guía_JavaScript_1.5/Concepto_general_de_LiveConnect/Conversiones_de_Tipo_de_Datos:	/en-US/docs/Archive/Web/LiveConnect/LiveConnect_Overview#Data_Type_Conversions
/es/docs/Web/JavaScript/Guide/Obsolete_Pages/Guía_JavaScript_1.5/Conversiones_de_tipos_de_datos	/en-US/docs/Archive/Web/LiveConnect/LiveConnect_Overview#Data_Type_Conversions
/es/docs/Web/JavaScript/Guide/Obsolete_Pages/Guía_JavaScript_1.5/Conversiones_de_tipos_de_datos/Conversiones_de_JavaScript_a_Java	/en-US/docs/Archive/Web/LiveConnect/LiveConnect_Overview#JavaScript_to_Java_Conversions
/es/docs/Web/JavaScript/Guide/Obsolete_Pages/Guía_JavaScript_1.5/Conversiones_de_tipos_de_datos/Conversiones_de_Java_a_JavaScript	/en-US/docs/Archive/Web/LiveConnect/LiveConnect_Overview#Java_to_JavaScript_Conversions
/es/docs/Web/JavaScript/Guide/Obsolete_Pages/Guía_JavaScript_1.5/Trabajando_con_envoltorios	/en-US/docs/Archive/Web/LiveConnect/LiveConnect_Overview#Working_with_Wrappers
/es/docs/Web/JavaScript/Novedades_en_JavaScript/Proximo_soporte_de_ECMAScript_en_Mozilla	/es/docs/Archive/Web/JavaScript/Proximo_soporte_de_ECMAScript_en_Mozilla
/es/docs/Web/JavaScript/Referencia/LiveConnect	/es/docs/Archive/Web/LiveConnect
/es/docs/Web/JavaScript/Referencia/Objetos_globales/JavaArray	/es/docs/Archive/Web/LiveConnect/JavaArray
/es/docs/Web/JavaScript/Referencia/Objetos_globales/JavaClass	/es/docs/Archive/Web/LiveConnect/JavaClass
/es/docs/Web/JavaScript/Referencia/Objetos_globales/JavaObject	/es/docs/Archive/Web/LiveConnect/JavaObject
/es/docs/Web/JavaScript/Referencia/Objetos_globales/JavaPackage	/es/docs/Archive/Web/LiveConnect/JavaPackage
/es/docs/Web/JavaScript/Referencia/Objetos_globales/Packages	/es/docs/Archive/Web/LiveConnect/Packages
/es/docs/Web/JavaScript/Referencia/Objetos_globales/java	/es/docs/Archive/Web/LiveConnect/java
/es/docs/Web/JavaScript/Referencia/Objetos_globales/netscape	/es/docs/Archive/Web/LiveConnect/netscape
/es/docs/Web/JavaScript/Referencia/Objetos_globales/sun	/es/docs/Archive/Web/LiveConnect/sun
/es/docs/Web/JavaScript/Referencia/Sentencias/Legacy_generator_function	/es/docs/Archive/Web/JavaScript/Legacy_generator_function_statement
/es/docs/XBL	/es/docs/Archive/Mozilla/XBL
/es/docs/XPCOM	/es/docs/Mozilla/XPCOM/XPCOM
/es/docs/XPCOM/Cambios_XPCOM_en_Gecko_2.0	/es/docs/Mozilla/XPCOM/XPCOM/Cambios_XPCOM_en_Gecko_2.0
/es/docs/XPCOM/XPCOM_changes_in_Gecko_2.0	/es/docs/Mozilla/XPCOM/XPCOM/XPCOM_changes_in_Gecko_2.0
/es/docs/XPIDL	/es/docs/Mozilla/Tech/XPIDL
/es/docs/nsIPrefBranch	/es/docs/Interfaces/nsIPrefBranch
/es/docs/persona/Browser_compatibility	/es/docs/Mozilla/Persona/Browser_compatibility
/es/docs/persona/Browser_compatibility-redirect-1	/es/docs/Mozilla/Persona/Browser_compatibility
/es/docs/persona/Compatibilidad_navegadores	/es/docs/Mozilla/Persona/Browser_compatibility
/es/docs/persona/branding	/es/docs/Mozilla/Persona/branding
/es/docs/persona/recursos-de-marca	/es/docs/Mozilla/Persona/branding
